회계연도,지역명,행사축제명,총비용,사업수익,순원가,시작월,종료월,index
2018,서울,서울특별시장기 생활체육대회,687200000,0,687200000,1,12,서울특별시장기 생활체육대회2018
2018,서울,서울빛초롱 축제(등 축제),1069409690,0,1069409690,11,11,서울빛초롱 축제(등 축제)2018
2018,서울,연등 축제,600000000,0,600000000,5,5,연등 축제2018
2018,서울,왕궁수문장 교대의식 재현,2309200000,0,2309200000,1,12,왕궁수문장 교대의식 재현2018
2018,서울,남산 봉수의식 등 전통문화 행사,750000000,0,750000000,1,12,남산 봉수의식 등 전통문화 행사2018
2018,서울,태권도 상설공연 행사,514100000,0,514100000,5,10,태권도 상설공연 행사2018
2018,서울,광화문ㆍ뚝섬 나눔장터 운영,602862160,0,602862160,4,11,광화문ㆍ뚝섬 나눔장터 운영2018
2018,서울,서울국제만화애니메이션페스티벌,570000000,0,570000000,8,8,서울국제만화애니메이션페스티벌2018
2018,서울,서울김장문화제,917255530,0,917255530,11,11,서울김장문화제2018
2018,서울,서울국제트래블마트 행사,880000000,0,880000000,9,9,서울국제트래블마트 행사2018
2018,서울,문화가 흐르는 서울광장 행사,984577000,0,984577000,4,10,문화가 흐르는 서울광장 행사2018
2018,서울,서울정원박람회,1329444760,40000000,1289444760,10,10,서울정원박람회2018
2018,서울,거리예술존 운영,666820000,0,666820000,4,11,거리예술존 운영2018
2018,서울,한강몽땅 여름축제,1140345110,0,1140345110,7,8,한강몽땅 여름축제2018
2018,서울,정조대왕 능행차 재현,1259300100,0,1259300100,10,10,정조대왕 능행차 재현2018
2018,서울,서울밤도깨비 야시장,2339341440,0,2339341440,3,10,서울밤도깨비 야시장2018
2018,서울,서울 크리스마스마켓 운영,553118536,0,553118536,12,12,서울 크리스마스마켓 운영2018
2018,서울,문화재야행,345608820,225000000,120608820,5,5,문화재야행2018
2018,서울,이태원지구촌축제,359680900,149500000,210180900,10,10,이태원지구촌축제2018
2018,서울,서울장미축제,562000000,140000000,422000000,5,5,서울장미축제2018
2018,서울,마포나루 새우젓축제,639250700,215000000,424250700,10,10,마포나루 새우젓축제2018
2018,서울,허준 축제,403500900,70000000,333500900,10,10,허준 축제2018
2018,서울,체육활동 활성화(종목별 대회 등),589979710,34990000,554989710,1,12,체육활동 활성화(종목별 대회 등)2018
2018,서울,구로 아시아 문화축제 개최,500000000,0,500000000,10,10,구로 아시아 문화축제 개최2018
2018,서울,서울구로국제어린이영화제,548748000,250000000,298748000,5,5,서울구로국제어린이영화제2018
2018,서울,영등포 여의도 봄꽃축제,420825000,180000000,240825000,4,4,영등포 여의도 봄꽃축제2018
2018,서울,2018 동작가족한마음축제,301918590,0,301918590,10,10,2018 동작가족한마음축제2018
2018,서울,서초금요음악회,319949020,0,319949020,1,12,서초금요음악회2018
2018,서울,권역별 찾아가는 서초토요벼룩시장,324728390,0,324728390,3,11,권역별 찾아가는 서초토요벼룩시장2018
2018,서울,국제평화마라톤,407298940,0,407298940,10,10,국제평화마라톤2018
2018,서울,강남페스티벌 패션쇼,419945590,0,419945590,10,10,강남페스티벌 패션쇼2018
2018,서울,강남페스티벌,917735130,0,917735130,9,10,강남페스티벌2018
2018,서울,서울놀이마당 상설전통공연,553976000,0,553976000,1,12,서울놀이마당 상설전통공연2018
2018,서울,한성백제문화제,484827810,0,484827810,10,10,한성백제문화제2018
2018,서울,강동선사문화축제,590000000,0,590000000,10,10,강동선사문화축제2018
2018,서울,친환경 도시농업 축제,517999090,284000000,233999090,5,5,친환경 도시농업 축제2018
2018,부산,부산항축제,620000000,200000000,420000000,5,5,부산항축제2018
2018,부산,부산국제영화제,6350000000,0,6350000000,10,10,부산국제영화제2018
2018,부산,부산국제광고제,1315307020,624090284,691216736,1,12,부산국제광고제2018
2018,부산,부산콘텐츠마켓,1692064563,897488277,794576286,5,5,부산콘텐츠마켓2018
2018,부산,국제게임전시회 (지스타),1984795000,0,1984795000,11,11,국제게임전시회 (지스타)2018
2018,부산,부산국제연극제,624000000,220000000,404000000,5,5,부산국제연극제2018
2018,부산,부산비엔날레,2500000000,950000000,1550000000,9,11,부산비엔날레2018
2018,부산,부산불꽃축제,1540000000,640000000,900000000,10,10,부산불꽃축제2018
2018,부산,부산바다축제,1000000000,0,1000000000,8,8,부산바다축제2018
2018,부산,부산국제록페스티벌,500000000,0,500000000,8,8,부산국제록페스티벌2018
2018,부산,부산수퍼컵 국제요트대회,614793226,186134000,428659226,4,5,부산수퍼컵 국제요트대회2018
2018,부산,부산국제모터쇼,700000000,0,700000000,6,6,부산국제모터쇼2018
2018,부산,부산국제음식박람회,500000000,0,500000000,10,10,부산국제음식박람회2018
2018,부산,부산국제코미디페스티벌,1199742325,599875799,599866526,8,9,부산국제코미디페스티벌2018
2018,부산,아시아송페스티벌,1400000000,700000000,700000000,10,10,아시아송페스티벌2018
2018,부산,부산원아시아페스티벌,3890122108,670000000,3220122108,10,10,부산원아시아페스티벌2018
2018,부산,세계마술올림픽,1100000000,0,1100000000,7,7,세계마술올림픽2018
2018,부산,부산자갈치축제,309438630,179845060,129593570,10,10,부산자갈치축제2018
2018,부산,영도다리축제,305000000,55000000,250000000,10,10,영도다리축제2018
2018,부산,동래읍성역사축제,485000000,145000000,340000000,10,10,동래읍성역사축제2018
2018,부산,낙동강 구포나루 축제,375000000,45000000,330000000,5,5,낙동강 구포나루 축제2018
2018,부산,해운대모래축제,460000000,0,460000000,5,5,해운대모래축제2018
2018,부산,금정산성역사문화축제,314539230,100000000,214539230,6,6,금정산성역사문화축제2018
2018,부산,광안리어방축제,669083900,264083903,404999997,4,4,광안리어방축제2018
2018,대구,대구국제섬유박람회,855000000,0,855000000,3,3,대구국제섬유박람회2018
2018,대구,대구국제마라톤대회,1864087939,0,1864087939,4,4,대구국제마라톤대회2018
2018,대구,대구국제안경전,729610437,0,729610437,4,4,대구국제안경전2018
2018,대구,대구국제뮤지컬페스티벌,2400000000,500000000,1900000000,6,7,대구국제뮤지컬페스티벌2018
2018,대구,대구패션페어,700000000,350000000,350000000,3,3,대구패션페어2018
2018,대구,컬러풀대구페스티벌,1864232960,800000000,1064232960,5,5,컬러풀대구페스티벌2018
2018,대구,대구국제오페라축제,2031599261,550000000,1481599261,9,10,대구국제오페라축제2018
2018,대구,팔공산산중전통장터(승시),600000000,270000000,330000000,10,10,팔공산산중전통장터(승시)2018
2018,대구,대구아트스퀘어,600000000,214197280,385802720,11,12,대구아트스퀘어2018
2018,대구,대구국제재즈축제,549925000,450000000,99925000,9,9,대구국제재즈축제2018
2018,대구,대한민국 도시농업박람회,600000000,300000000,300000000,9,9,대한민국 도시농업박람회2018
2018,대구,대구치맥페스티벌,1848087691,0,1848087691,7,7,대구치맥페스티벌2018
2018,대구,대구국제패션문화페스티벌,623429709,320000000,303429709,10,10,대구국제패션문화페스티벌2018
2018,대구,문화재야행프로그램,359814600,0,359814600,8,9,문화재야행프로그램2018
2018,대구,100대 피아노콘서트,603556997,150000000,453556997,9,9,100대 피아노콘서트2018
2018,인천,펜타포트 음악축제,2500000000,0,2500000000,1,12,펜타포트 음악축제2018
2018,인천,인천한류관광콘서트,819992975,320000000,499992975,9,9,인천한류관광콘서트2018
2018,인천,제17회 세계검도선수권대회,749465159,0,749465159,9,9,제17회 세계검도선수권대회2018
2018,인천,LPGA 2018 UL 인터내셔널 크라운 대회,801699112,0,801699112,10,10,LPGA 2018 UL 인터내셔널 크라운 대회2018
2018,인천,개항장 컬쳐나잇,426876300,320157230,106719070,9,10,개항장 컬쳐나잇2018
2018,인천,소래포구축제,459839410,0,459839410,10,10,소래포구축제2018
2018,인천,부평풍물대축제,625851010,0,625851010,10,10,부평풍물대축제2018
2018,인천,정서진피크닉클래식,499822000,0,499822000,9,9,정서진피크닉클래식2018
2018,인천,고려역사문화제,565217370,0,565217370,7,7,고려역사문화제2018
2018,광주,광주세계김치축제,896642900,0,896642900,10,10,광주세계김치축제2018
2018,광주,광주ACE Fair,1397089018,698507230,698581788,9,9,광주ACE Fair2018
2018,광주,광주비엔날레,8878974000,1800000000,7078974000,9,11,광주비엔날레2018
2018,광주,광주프린지페스티벌,1470201940,0,1470201940,2,12,광주프린지페스티벌2018
2018,광주,공연장상주단체육성지원,668375800,334187900,334187900,1,12,공연장상주단체육성지원2018
2018,광주,추억의충장축제,1332130120,1010000000,322130120,1,12,추억의충장축제2018
2018,광주,아시아음식문화지구 조성사업,317243600,0,317243600,1,12,아시아음식문화지구 조성사업2018
2018,대전,대전국제와인페어,900000000,0,900000000,8,9,대전국제와인페어2018
2018,대전,대전사이언스페스티벌,1215000000,15000000,1200000000,10,10,대전사이언스페스티벌2018
2018,대전,전국 장애인 체육대회 개최 및 참가,538004790,0,538004790,1,12,전국 장애인 체육대회 개최 및 참가2018
2018,대전,대전비엔날레,864716855,0,864716855,7,10,대전비엔날레2018
2018,대전,효문화 뿌리축제,829284800,130000000,699284800,10,10,효문화 뿌리축제2018
2018,대전,대전 서구힐링 아트페스티벌,631898000,0,631898000,5,5,대전 서구힐링 아트페스티벌2018
2018,대전,2018 유성온천문화축제,811072060,0,811072060,5,5,2018 유성온천문화축제2018
2018,울산,서머페스티벌,900000000,0,900000000,7,7,서머페스티벌2018
2018,울산,한글문화예술제,570000000,0,570000000,10,10,한글문화예술제2018
2018,울산,창작뮤지컬 '외솔 겨레의 등불 최현배',749996670,0,749996670,7,9,창작뮤지컬 '외솔 겨레의 등불 최현배'2018
2018,울산,울산대공원 장미원 빛 축제,565090000,144559000,420531000,12,1,울산대공원 장미원 빛 축제2018
2018,울산,수요열린예술무대 뒤란,583263000,40278910,542984090,2,12,수요열린예술무대 뒤란2018
2018,울산,태화강 정원박람회,1491264742,0,1491264742,4,4,태화강 정원박람회2018
2018,울산,울산마두희축제,819000000,0,819000000,6,6,울산마두희축제2018
2018,울산,태화강 스프링 재즈페스티벌,360000000,0,360000000,5,5,태화강 스프링 재즈페스티벌2018
2018,울산,울산고래축제,1513174000,0,1513174000,7,7,울산고래축제2018
2018,울산,구립교향악단 정기연주회,437088000,0,437088000,1,12,구립교향악단 정기연주회2018
2018,울산,울산조선해양축제,498552500,200000000,298552500,7,6,울산조선해양축제2018
2018,울산,울산쇠부리축제,588000000,200000000,388000000,5,5,울산쇠부리축제2018
2018,울산,울산옹기축제,712500000,20000000,692500000,5,5,울산옹기축제2018
2018,울산,울산진하PWA세계윈드서핑대회,546555823,150000000,396555823,5,5,울산진하PWA세계윈드서핑대회2018
2018,울산,울산진하세계여자비치발리볼대회,378000000,0,378000000,7,7,울산진하세계여자비치발리볼대회2018
2018,울산,간절곶해맞이행사,437882000,200000000,237882000,12,1,간절곶해맞이행사2018
2018,울산,울주세계산악영화제,2350000000,0,2350000000,9,9,울주세계산악영화제2018
2018,세종,세종시민체육대회,504941820,0,504941820,10,10,세종시민체육대회2018
2018,세종,세종축제,1209879720,0,1209879720,10,10,세종축제2018
2018,경기,도(道)단위 생활체육대회 개최,616290820,0,616290820,4,10,도(道)단위 생활체육대회 개최2018
2018,경기,군장병 위문공연,536000000,0,536000000,4,10,군장병 위문공연2018
2018,경기,경기국제보트쇼,1299064081,0,1299064081,5,5,경기국제보트쇼2018
2018,경기,대한민국 뷰티박람회,1412752061,0,1412752061,10,10,대한민국 뷰티박람회2018
2018,경기,플레이엑스포,1700000000,0,1700000000,5,5,플레이엑스포2018
2018,경기,대한민국 우수상품 전시회(G-FAIR KOREA),1500000000,0,1500000000,10,10,대한민국 우수상품 전시회(G-FAIR KOREA)2018
2018,경기,안전산업박람회,552445900,0,552445900,11,11,안전산업박람회2018
2018,경기,찾아가는 경기관광박람회,600000000,0,600000000,4,4,찾아가는 경기관광박람회2018
2018,경기,DMZ국제다큐영화제,1983562591,0,1983562591,9,9,DMZ국제다큐영화제2018
2018,경기,경기정원문화박람회,500000000,0,500000000,10,10,경기정원문화박람회2018
2018,경기,판교 자율주행모터쇼,1600000000,0,1600000000,11,11,판교 자율주행모터쇼2018
2018,경기,수원화성문화제,1626876470,123904090,1502972380,10,10,수원화성문화제2018
2018,경기,정조대왕 능행차 연시,990021410,5644000,984377410,10,10,정조대왕 능행차 연시2018
2018,경기,정보과학축제,538185000,0,538185000,10,10,정보과학축제2018
2018,경기,수원 JS컵 U-18 국제 청소년 축구대회,439515000,0,439515000,4,4,수원 JS컵 U-18 국제 청소년 축구대회2018
2018,경기,기획전 개최,889080120,105325000,783755120,1,12,기획전 개최2018
2018,경기,수원 문화재 야행,597347200,0,597347200,8,9,수원 문화재 야행2018
2018,경기,수원연극축제,557028920,110000000,447028920,5,5,수원연극축제2018
2018,경기,시민체육대회,999738960,0,999738960,10,11,시민체육대회2018
2018,경기,경기도 체육대회,489569320,0,489569320,4,4,경기도 체육대회2018
2018,경기,경기도 지역대표공연예술제 지원사업 (의정부음악극축제),769200000,0,769200000,5,5,경기도 지역대표공연예술제 지원사업 (의정부음악극축제)2018
2018,경기,안양시민축제,582657340,0,582657340,9,9,안양시민축제2018
2018,경기,복사골예술제,360000000,0,360000000,5,5,복사골예술제2018
2018,경기,부천국제판타스틱영화제,2492345790,0,2492345790,7,7,부천국제판타스틱영화제2018
2018,경기,부천국제애니메이션페스티벌,1045851880,0,1045851880,10,10,부천국제애니메이션페스티벌2018
2018,경기,부천국제만화축제,449290000,0,449290000,8,8,부천국제만화축제2018
2018,경기,전국도단위 이상 대회 개최,307300000,0,307300000,3,12,전국도단위 이상 대회 개최2018
2018,경기,부천 세계비보이 대회,528969000,169900000,359069000,9,9,부천 세계비보이 대회2018
2018,경기,경기정원문화박람회,686500110,0,686500110,10,10,경기정원문화박람회2018
2018,경기,특별기획전시,307803000,0,307803000,1,11,특별기획전시2018
2018,경기,물놀이장 운영,340376530,43370000,297006530,7,8,물놀이장 운영2018
2018,경기,안산국제거리극,1267172412,0,1267172412,5,5,안산국제거리극2018
2018,경기,시장기 생활체육대회 개최,494138290,0,494138290,1,12,시장기 생활체육대회 개최2018
2018,경기,국제 및 전국대회 유치,300000000,0,300000000,1,12,국제 및 전국대회 유치2018
2018,경기,고양국제꽃박람회,1469219230,0,1469219230,4,5,고양국제꽃박람회2018
2018,경기,고양행주문화제,300000000,0,300000000,9,9,고양행주문화제2018
2018,경기,과천축제,1044507000,0,1044507000,9,9,과천축제2018
2018,경기,세계3쿠션 당구월드컵 개최,400000000,0,400000000,11,11,세계3쿠션 당구월드컵 개최2018
2018,경기,남양주 다산문화제,596247000,3324000,592923000,9,9,남양주 다산문화제2018
2018,경기,북한강 야외공연장 상설공연,336104610,2849000,333255610,4,10,북한강 야외공연장 상설공연2018
2018,경기,다산아트홀 공연 운영,499948160,52411000,447537160,5,12,다산아트홀 공연 운영2018
2018,경기,오산 독산성문화제,639878749,0,639878749,10,10,오산 독산성문화제2018
2018,경기,생활체육대회 개최 및 출전지원,493536000,0,493536000,3,10,생활체육대회 개최 및 출전지원2018
2018,경기,갯골축제,720000000,120000000,600000000,9,9,갯골축제2018
2018,경기,군포철쭉축제,451153000,0,451153000,4,4,군포철쭉축제2018
2018,경기,의왕철도축제,363405870,0,363405870,5,5,의왕철도축제2018
2018,경기,용인시협회장배 체육대회,344704500,0,344704500,1,12,용인시협회장배 체육대회2018
2018,경기,전국(도단위) 체육대회,538000000,0,538000000,1,12,전국(도단위) 체육대회2018
2018,경기,마티네콘서트,303667000,0,303667000,3,12,마티네콘서트2018
2018,경기,파주북소리,380000000,0,380000000,9,9,파주북소리2018
2018,경기,파주개성인삼축제,400000000,0,400000000,10,10,파주개성인삼축제2018
2018,경기,파주장단콩축제,419840000,0,419840000,11,11,파주장단콩축제2018
2018,경기,파주시민 대축제,483298270,0,483298270,9,9,파주시민 대축제2018
2018,경기,이천도자기축제,660481000,0,660481000,10,10,이천도자기축제2018
2018,경기,이천쌀문화축제,737900000,0,737900000,10,10,이천쌀문화축제2018
2018,경기,설봉산별빛축제,361000000,0,361000000,7,8,설봉산별빛축제2018
2018,경기,이천국제조각심포지엄,450000000,0,450000000,8,8,이천국제조각심포지엄2018
2018,경기,안성맞춤 남사당 바우덕이 축제,1443605530,178900000,1264705530,10,10,안성맞춤 남사당 바우덕이 축제2018
2018,경기,정조효문화제,1158619000,0,1158619000,10,10,정조효문화제2018
2018,경기,햇살드리 농특산물 전시홍보판매행사,377201790,0,377201790,1,12,햇살드리 농특산물 전시홍보판매행사2018
2018,경기,화성도시농업박람회,695397000,0,695397000,9,9,화성도시농업박람회2018
2018,경기,화성송산포도축제,300000000,0,300000000,9,9,화성송산포도축제2018
2018,경기,예술단체지원사업,428919820,0,428919820,10,11,예술단체지원사업2018
2018,경기,U-12 전국 유소년 야구대회 및 전국 여자 야구대회,391737040,0,391737040,7,7,U-12 전국 유소년 야구대회 및 전국 여자 야구대회2018
2018,경기,화성뱃놀이축제,1958143740,0,1958143740,5,6,화성뱃놀이축제2018
2018,경기,광주 왕실 도자기 축제,398615000,0,398615000,4,5,광주 왕실 도자기 축제2018
2018,경기,광주 남한산성 문화제,370000000,0,370000000,10,10,광주 남한산성 문화제2018
2018,경기,2018 양주 천만송이 천일홍 축제,498325000,0,498325000,9,9,2018 양주 천만송이 천일홍 축제2018
2018,경기,2018 세종대왕 문화제,831586000,0,831586000,10,10,2018 세종대왕 문화제2018
2018,경기,여주도자기축제,746775000,0,746775000,5,5,여주도자기축제2018
2018,경기,여주오곡나루축제,908229000,160000000,748229000,10,10,여주오곡나루축제2018
2018,경기,연천DMZ국제음악제,380000000,0,380000000,7,7,연천DMZ국제음악제2018
2018,경기,연천전곡리 구석기축제,784100000,31848000,752252000,5,5,연천전곡리 구석기축제2018
2018,경기,양평 용문산 산나물 축제,671032000,20862000,650170000,5,5,양평 용문산 산나물 축제2018
2018,강원,평창대관령음악제,1618994000,546900000,1072094000,7,8,평창대관령음악제2018
2018,강원,GTI 국제무역 투자박람회,2175189000,897268000,1277921000,9,9,GTI 국제무역 투자박람회2018
2018,강원,드림프로그램,1278336000,639168000,639168000,12,12,드림프로그램2018
2018,강원,국제유소년(U15) 축구대회,1484609000,0,1484609000,8,11,국제유소년(U15) 축구대회2018
2018,강원,강원도 평화통일 페스티벌,599786360,0,599786360,11,11,강원도 평화통일 페스티벌2018
2018,강원,대한민국 탄소 포럼,500000000,0,500000000,10,10,대한민국 탄소 포럼2018
2018,강원,강원국제미술전람회,2247389000,979182000,1268207000,2,3,강원국제미술전람회2018
2018,강원,평화지역 상설 문화공연,2500000000,0,2500000000,10,12,평화지역 상설 문화공연2018
2018,강원,강원 K-POP페스티벌,2971881000,1485940000,1485941000,2,3,강원 K-POP페스티벌2018
2018,강원,올림픽 성공기념 국민감사 대축제(방송광고),2358569000,1179284000,1179285000,4,4,올림픽 성공기념 국민감사 대축제(방송광고)2018
2018,강원,문화올림픽 문화패럴림픽 개막축제,1072900000,536450000,536450000,2,2,문화올림픽 문화패럴림픽 개막축제2018
2018,강원,2018 문화올림픽 문화예술공연,3229497000,1614748000,1614749000,2,3,2018 문화올림픽 문화예술공연2018
2018,강원,남북강원도 PEACE WEEK(2019 평창평화포럼),1100000000,0,1100000000,2,2,남북강원도 PEACE WEEK(2019 평창평화포럼)2018
2018,강원,춘천마임축제,603904212,103981690,499922522,5,5,춘천마임축제2018
2018,강원,춘천인형극제,539469216,200000000,339469216,9,10,춘천인형극제2018
2018,강원,춘천국제연극제,328946081,148946081,180000000,6,6,춘천국제연극제2018
2018,강원,춘천 국제레저대회,1600000000,300000000,1300000000,8,8,춘천 국제레저대회2018
2018,강원,춘천향토음식축제,459421000,0,459421000,8,9,춘천향토음식축제2018
2018,강원,춘천가족음악축제,399715838,0,399715838,9,9,춘천가족음악축제2018
2018,강원,제1회 춘천세계불꽃축제,307483510,199864282,107619228,7,7,제1회 춘천세계불꽃축제2018
2018,강원,장난감축제(토이페스티벌),399896400,0,399896400,10,10,장난감축제(토이페스티벌)2018
2018,강원,2018 IDO 총회 및 월드댄스컵대회,399575700,200000000,199575700,8,8,2018 IDO 총회 및 월드댄스컵대회2018
2018,강원,원주다이내믹댄싱카니발,1528653140,0,1528653140,9,9,원주다이내믹댄싱카니발2018
2018,강원,강릉 단오제,1444960500,250000000,1194960500,5,6,강릉 단오제2018
2018,강원,강릉커피축제,390445000,40000000,350445000,10,10,강릉커피축제2018
2018,강원,경포썸머페스티벌,342104520,0,342104520,7,8,경포썸머페스티벌2018
2018,강원,문화재 야행,718844000,539133000,179711000,8,9,문화재 야행2018
2018,강원,2018년 강릉푸드페스티벌 행사,512922990,0,512922990,2,2,2018년 강릉푸드페스티벌 행사2018
2018,강원,태백산눈축제,1277949000,108500000,1169449000,1,2,태백산눈축제2018
2018,강원,전국추계대학축구연맹전,384000000,0,384000000,8,8,전국추계대학축구연맹전2018
2018,강원,"한강,낙동강 발원지축제",721518690,0,721518690,7,8,"한강,낙동강 발원지축제2018"
2018,강원,설악문화제,630863250,5000000,625863250,9,12,설악문화제2018
2018,강원,제18회 세계한민족여성네트워크 대회,307932860,92700000,215232860,8,8,제18회 세계한민족여성네트워크 대회2018
2018,강원,이사부역사문화축전,400000000,0,400000000,9,9,이사부역사문화축전2018
2018,강원,기줄다리기와 함께하는 삼척정월대보름제,602511940,0,602511940,2,2,기줄다리기와 함께하는 삼척정월대보름제2018
2018,강원,삼척 황영조 국제마라톤대회,349674000,0,349674000,4,4,삼척 황영조 국제마라톤대회2018
2018,강원,치어업 삼척 스포츠문화 관광산업 육성 프로젝트,600000000,450000000,150000000,8,9,치어업 삼척 스포츠문화 관광산업 육성 프로젝트2018
2018,강원,홍천 무궁화축제,387958740,0,387958740,10,10,홍천 무궁화축제2018
2018,강원,홍천강 인삼송어축제,1498830370,0,1498830370,1,1,홍천강 인삼송어축제2018
2018,강원,홍천강 별빛음악맥주축제,449183420,0,449183420,8,8,홍천강 별빛음악맥주축제2018
2018,강원,횡성한우축제,2029171000,40000000,1989171000,10,10,횡성한우축제2018
2018,강원,2018 설날씨름대회(도),350000000,0,350000000,2,2,2018 설날씨름대회(도)2018
2018,강원,동강국제사진제,553363000,0,553363000,6,9,동강국제사진제2018
2018,강원,단종문화제,880000000,155000000,725000000,4,4,단종문화제2018
2018,강원,김삿갓문화제,343000000,0,343000000,10,10,김삿갓문화제2018
2018,강원,제53회 강원도민체육대회,1000000000,0,1000000000,6,6,제53회 강원도민체육대회2018
2018,강원,오대산문화축전,400000000,200000000,200000000,10,10,오대산문화축전2018
2018,강원,대관령눈꽃축제,348000000,0,348000000,2,2,대관령눈꽃축제2018
2018,강원,평창송어축제,654000000,110000000,544000000,12,2,평창송어축제2018
2018,강원,평창효석문화제,883000000,260000000,623000000,9,9,평창효석문화제2018
2018,강원,"대한민국 아리랑 대축제, 정선아리랑제",709000000,0,709000000,10,10,"대한민국 아리랑 대축제, 정선아리랑제2018"
2018,강원,고드름축제,1135849700,0,1135849700,2,2,고드름축제2018
2018,강원,전국 5일장 박람회,594300000,0,594300000,6,6,전국 5일장 박람회2018
2018,강원,철원화강 다슬기축제,721681650,0,721681650,8,8,철원화강 다슬기축제2018
2018,강원,태봉제,692413820,0,692413820,10,10,태봉제2018
2018,강원,한탄강 얼음트레킹행사,551475220,0,551475220,1,1,한탄강 얼음트레킹행사2018
2018,강원,얼음나라 화천 산천어 축제,5147216936,0,5147216936,1,1,얼음나라 화천 산천어 축제2018
2018,강원,물의 나라 화천 쪽배 축제,516246482,0,516246482,7,8,물의 나라 화천 쪽배 축제2018
2018,강원,화천 토마토 축제,490993000,0,490993000,8,8,화천 토마토 축제2018
2018,강원,군부대 페스티벌 행사,324000000,0,324000000,9,10,군부대 페스티벌 행사2018
2018,강원,배꼽축제,431620370,0,431620370,7,7,배꼽축제2018
2018,강원,빙어축제,1499876350,0,1499876350,1,2,빙어축제2018
2018,강원,만해축전,540338581,0,540338581,8,8,만해축전2018
2018,강원,2018 대한민국 산림문화박람회,1500000000,0,1500000000,10,10,2018 대한민국 산림문화박람회2018
2018,강원,고성명태축제,598080000,0,598080000,10,10,고성명태축제2018
2018,강원,양양 송이 축제,529505980,26735350,502770630,9,10,양양 송이 축제2018
2018,강원,양양 연어 축제,482858940,87554880,395304060,10,10,양양 연어 축제2018
2018,강원,양양문화제,449480530,0,449480530,6,6,양양문화제2018
2018,충북,솔라페스티벌,753127740,55000000,698127740,9,9,솔라페스티벌2018
2018,충북,중국인유학생페스티벌,997260380,400000000,597260380,9,9,중국인유학생페스티벌2018
2018,충북,오송화장품뷰티산업엑스포,2492672797,800000000,1692672797,10,10,오송화장품뷰티산업엑스포2018
2018,충북,제12회 전국장애학생체육대회,902617280,0,902617280,5,5,제12회 전국장애학생체육대회2018
2018,충북,2018년 제47회 전국소년체육대회,2869305020,0,2869305020,5,5,2018년 제47회 전국소년체육대회2018
2018,충북,충주세계소방관경기대회,5272072380,0,5272072380,9,9,충주세계소방관경기대회2018
2018,충북,충주호수축제,790679160,0,790679160,8,8,충주호수축제2018
2018,충북,우륵문화제,300000000,0,300000000,9,9,우륵문화제2018
2018,충북,농업경영인 대회 행사 지원,500000000,0,500000000,8,8,농업경영인 대회 행사 지원2018
2018,충북,국제무예연무대회,379947000,0,379947000,10,10,국제무예연무대회2018
2018,충북,제천국제음악영화제,1980000000,400000000,1580000000,8,8,제천국제음악영화제2018
2018,충북,추계 한국중등(U-15)축구연맹전,600000000,0,600000000,8,8,추계 한국중등(U-15)축구연맹전2018
2018,충북,제천한방바이오박람회,1380000000,360000000,1020000000,10,10,제천한방바이오박람회2018
2018,충북,청원생명축제,2493537710,46022330,2447515380,10,10,청원생명축제2018
2018,충북,세종대왕과 초정약수 축제,576254900,30000000,546254900,5,5,세종대왕과 초정약수 축제2018
2018,충북,제27회 전국무용제,599965792,0,599965792,8,9,제27회 전국무용제2018
2018,충북,청원생명축제 지원,527289346,0,527289346,9,10,청원생명축제 지원2018
2018,충북,보은대추축제,837807010,0,837807010,10,10,보은대추축제2018
2018,충북,보은장사 씨름대회,340000000,0,340000000,6,6,보은장사 씨름대회2018
2018,충북,지용제,326000000,0,326000000,5,5,지용제2018
2018,충북,향수옥천 포도복숭아 축제,374000000,0,374000000,7,7,향수옥천 포도복숭아 축제2018
2018,충북,영동난계국악축제,1149290650,190000000,959290650,10,10,영동난계국악축제2018
2018,충북,영동포도축제,903137940,0,903137940,8,8,영동포도축제2018
2018,충북,대한민국와인축제,353740000,0,353740000,10,10,대한민국와인축제2018
2018,충북,영동 곶감 축제,469918020,0,469918020,12,12,영동 곶감 축제2018
2018,충북,생거진천 문화축제,426091060,0,426091060,10,10,생거진천 문화축제2018
2018,충북,솔라 페스티벌,756332240,0,756332240,9,9,솔라 페스티벌2018
2018,충북,괴산고추축제,0,0,0,8,9,괴산고추축제2018
2018,충북,음성품바축제,657099900,160000000,497099900,5,5,음성품바축제2018
2018,충북,음성인삼축제,355000000,0,355000000,10,10,음성인삼축제2018
2018,충북,소백산철쭉제,450000000,0,450000000,5,5,소백산철쭉제2018
2018,충북,온달문화축제,550000000,0,550000000,10,10,온달문화축제2018
2018,충북,증평인삼골축제,325000000,30000000,295000000,10,10,증평인삼골축제2018
2018,충남,백제문화제,1780000000,0,1780000000,9,9,백제문화제2018
2018,충남,2018전국생활체육대축전,2317538190,0,2317538190,5,5,2018전국생활체육대축전2018
2018,충남,천안흥타령춤축제,2547171521,400000000,2147171521,9,9,천안흥타령춤축제2018
2018,충남,천안시민체육대회,654673911,0,654673911,10,10,천안시민체육대회2018
2018,충남,대한민국 국제농기계자재박람회,1033031730,0,1033031730,10,11,대한민국 국제농기계자재박람회2018
2018,충남,금강자연미술비엔날레,483196689,0,483196689,2,12,금강자연미술비엔날레2018
2018,충남,백제문화제,3362057000,0,3362057000,9,9,백제문화제2018
2018,충남,석장리세계구석기축제(기반시설조성 및 체험프로그램운영),426254480,0,426254480,5,5,석장리세계구석기축제(기반시설조성 및 체험프로그램운영)2018
2018,충남,석장리 구석기 축제,700000000,127567000,572433000,5,5,석장리 구석기 축제2018
2018,충남,2018 공주 문화재 야행,418400000,0,418400000,6,8,2018 공주 문화재 야행2018
2018,충남,공주문예회관 기획공연,388829480,0,388829480,1,12,공주문예회관 기획공연2018
2018,충남,보령머드축제,2852869000,0,2852869000,7,7,보령머드축제2018
2018,충남,성웅이순신축제,301438440,0,301438440,4,4,성웅이순신축제2018
2018,충남,서산국화축제,335000000,0,335000000,10,11,서산국화축제2018
2018,충남,서산해미읍성축제,880000000,0,880000000,10,10,서산해미읍성축제2018
2018,충남,2018년 읍면동화합체육대회,495000000,0,495000000,9,10,2018년 읍면동화합체육대회2018
2018,충남,강경젓갈축제,825000000,183950000,641050000,10,10,강경젓갈축제2018
2018,충남,논산딸기축제,752842925,0,752842925,4,4,논산딸기축제2018
2018,충남,계룡군문화축제,1960892220,650000000,1310892220,10,10,계룡군문화축제2018
2018,충남,충남장애인체육대회 개최,1140094610,0,1140094610,9,9,충남장애인체육대회 개최2018
2018,충남,금산인삼축제,2124975949,0,2124975949,10,10,금산인삼축제2018
2018,충남,금산인삼 대도시 순회 특별전,288600000,219350000,69250000,4,11,금산인삼 대도시 순회 특별전2018
2018,충남,부여서동연꽃축제,1300000000,0,1300000000,7,7,부여서동연꽃축제2018
2018,충남,백제문화제,2473250000,0,2473250000,9,9,백제문화제2018
2018,충남,한산모시문화제,1082710030,170000000,912710030,6,6,한산모시문화제2018
2018,충남,청양 고추구기자축제,531018120,0,531018120,9,9,청양 고추구기자축제2018
2018,충남,"2018 청양고추배
바둑대회",50000000,0,50000000,12,12,"2018 청양고추배
바둑대회2018"
2018,충남,홍성역사인물축제,635000000,0,635000000,9,9,홍성역사인물축제2018
2018,전북,전주세계소리축제,2150000000,500000000,1650000000,10,10,전주세계소리축제2018
2018,전북,새만금상설공연,1638783510,687596340,951187170,4,11,새만금상설공연2018
2018,전북,전주국제발효식품엑스포,957000000,0,957000000,10,10,전주국제발효식품엑스포2018
2018,전북,전라북도 브랜드 공연,596135550,0,596135550,1,12,전라북도 브랜드 공연2018
2018,전북,제99회 전국체육대회,22078745951,4200000000,17878745951,10,10,제99회 전국체육대회2018
2018,전북,제38회 전국장애인체육대회,4384593150,1291000000,3093593150,10,10,제38회 전국장애인체육대회2018
2018,전북,도지사기 등 종목별체육대회,659173830,0,659173830,1,12,도지사기 등 종목별체육대회2018
2018,전북,전주국제영화제,3550000000,950000000,2600000000,5,5,전주국제영화제2018
2018,전북,전주비빔밥축제,480000000,30000000,450000000,10,10,전주비빔밥축제2018
2018,전북,전주대사습놀이 전국대회,500000000,350000000,150000000,6,6,전주대사습놀이 전국대회2018
2018,전북,전주오픈국제태권도대회,340000000,185000000,155000000,7,7,전주오픈국제태권도대회2018
2018,전북,전주문화재 야행,397894650,258631470,139263180,5,9,전주문화재 야행2018
2018,전북,전주얼티밋 뮤직페스티벌,300000000,0,300000000,8,8,전주얼티밋 뮤직페스티벌2018
2018,전북,군산새만금국제마라톤,1150000000,400000000,750000000,4,4,군산새만금국제마라톤2018
2018,전북,금석배 전국학생 축구대회,400000000,90000000,310000000,1,2,금석배 전국학생 축구대회2018
2018,전북,군산시간여행축제,653087850,50000000,603087850,9,9,군산시간여행축제2018
2018,전북,군산야행,719999760,467999844,251999916,8,10,군산야행2018
2018,전북,익산서동축제,627729000,30000000,597729000,5,5,익산서동축제2018
2018,전북,익산천만송이국화축제,925851800,0,925851800,10,11,익산천만송이국화축제2018
2018,전북,전국(장애인)체전 문화예술행사,550000000,275000000,275000000,10,10,전국(장애인)체전 문화예술행사2018
2018,전북,정읍구절초축제,742687990,50000000,692687990,10,10,정읍구절초축제2018
2018,전북,춘향제,1265844820,550000000,715844820,5,5,춘향제2018
2018,전북,남원 코리아오픈 국제롤러 경기대회,608227240,370000000,238227240,9,9,남원 코리아오픈 국제롤러 경기대회2018
2018,전북,김제지평선축제,1999700000,30000000,1969700000,10,10,김제지평선축제2018
2018,전북,완주와일드푸드축제,739911000,0,739911000,10,10,완주와일드푸드축제2018
2018,전북,진안홍삼축제,799863000,0,799863000,10,10,진안홍삼축제2018
2018,전북,무주반딧불축제,2849963580,410000000,2439963580,9,9,무주반딧불축제2018
2018,전북,세계태권도문화엑스포,500000000,200000000,300000000,7,7,세계태권도문화엑스포2018
2018,전북,무주산골영화제,680000000,80000000,600000000,6,6,무주산골영화제2018
2018,전북,장수 한우랑 사과랑 축제,869853830,0,869853830,9,9,장수 한우랑 사과랑 축제2018
2018,전북,임실N치즈축제,842440420,410000000,432440420,10,10,임실N치즈축제2018
2018,전북,순창장류축제,849930570,150000000,699930570,10,10,순창장류축제2018
2018,전북,모양성제,750000000,150000000,600000000,10,10,모양성제2018
2018,전북,고창국화축제,609959040,0,609959040,10,11,고창국화축제2018
2018,전북,부안마실축제,886684960,190000000,696684960,5,5,부안마실축제2018
2018,전남,남도음식문화큰잔치,500000000,0,500000000,10,10,남도음식문화큰잔치2018
2018,전남,명량대첩축제,1300000000,0,1300000000,9,9,명량대첩축제2018
2018,전남,국수산맥 국제바둑대회 개최,997832200,0,997832200,5,10,국수산맥 국제바둑대회 개최2018
2018,전남,전남 GT(그랜드투어링),639689500,0,639689500,9,9,전남 GT(그랜드투어링)2018
2018,전남,전남 국제수묵화 비엔날레 추진,3800000000,0,3800000000,9,10,전남 국제수묵화 비엔날레 추진2018
2018,전남,국제 철인3종경기대회,591572610,0,591572610,9,9,국제 철인3종경기대회2018
2018,전남,목포항구축제,602750000,80000000,522750000,10,10,목포항구축제2018
2018,전남,목포문화재야행,359952000,0,359952000,9,9,목포문화재야행2018
2018,전남,여수거북선축제,848633919,0,848633919,5,5,여수거북선축제2018
2018,전남,경로위안잔치,399982700,0,399982700,10,11,경로위안잔치2018
2018,전남,여수밤바다 불꽃축제,400000000,0,400000000,9,9,여수밤바다 불꽃축제2018
2018,전남,전라남도 생활체육대축전,387920220,0,387920220,10,10,전라남도 생활체육대축전2018
2018,전남,전라남도장애인체육대회,636107230,80000000,556107230,4,4,전라남도장애인체육대회2018
2018,전남,순천만세계동물영화제 개최,726512000,0,726512000,8,8,순천만세계동물영화제 개최2018
2018,전남,순천 시민의 날 및 팔마문화제 행사,620152110,0,620152110,10,10,순천 시민의 날 및 팔마문화제 행사2018
2018,전남,항꾼에 즐기는 아고라순천 문화예술 행사,759738860,0,759738860,4,11,항꾼에 즐기는 아고라순천 문화예술 행사2018
2018,전남,순천만국가정원 봄꽃축제,301076000,0,301076000,4,5,순천만국가정원 봄꽃축제2018
2018,전남,순천만국가정원 물빛축제,365700500,0,365700500,7,8,순천만국가정원 물빛축제2018
2018,전남,정원갈대축제,509859700,0,509859700,9,10,정원갈대축제2018
2018,전남,제3회 순천세계주니어정구선수권대회,616911921,0,616911921,11,11,제3회 순천세계주니어정구선수권대회2018
2018,전남,순천 문화재 야행,714497200,0,714497200,8,12,순천 문화재 야행2018
2018,전남,순천만국제교향악축제,549977000,0,549977000,8,9,순천만국제교향악축제2018
2018,전남,2018 대한민국 문화의 달,600000000,0,600000000,10,10,2018 대한민국 문화의 달2018
2018,전남,2018 순천 푸드아트페스티벌,580000000,0,580000000,9,9,2018 순천 푸드아트페스티벌2018
2018,전남,마한문화축제,500000000,0,500000000,10,10,마한문화축제2018
2018,전남,광양매화축제,300000000,0,300000000,3,3,광양매화축제2018
2018,전남,담양대나무축제,709129900,20000000,689129900,5,5,담양대나무축제2018
2018,전남,제8회 곡성세계장미축제,300000000,1319292000,-1019292000,5,5,제8회 곡성세계장미축제2018
2018,전남,구례산수유꽃축제,490000000,0,490000000,3,3,구례산수유꽃축제2018
2018,전남,지리산남악제 및 군민의 날 행사,300000000,0,300000000,4,4,지리산남악제 및 군민의 날 행사2018
2018,전남,국제철인3종경기,600000000,400000000,200000000,9,9,국제철인3종경기2018
2018,전남,고흥우주항공축제,317379000,0,317379000,7,8,고흥우주항공축제2018
2018,전남,서편제보성소리축제,410000000,0,410000000,10,10,서편제보성소리축제2018
2018,전남,보성차밭빛축제,846189840,0,846189840,12,1,보성차밭빛축제2018
2018,전남,보성다향대축제,680000000,0,680000000,5,5,보성다향대축제2018
2018,전남,2018 화순 국화향연,828177830,0,828177830,10,11,2018 화순 국화향연2018
2018,전남,정남진장흥물축제,1500000000,0,1500000000,7,8,정남진장흥물축제2018
2018,전남,대한민국통합의학박람회,1077154940,0,1077154940,10,10,대한민국통합의학박람회2018
2018,전남,강진청자축제,1320000000,0,1320000000,7,8,강진청자축제2018
2018,전남,강진만 춤추는 갈대축제,400000000,0,400000000,10,10,강진만 춤추는 갈대축제2018
2018,전남,남도음식문화큰잔치,360000000,0,360000000,10,10,남도음식문화큰잔치2018
2018,전남,왕인문화 축제,970000000,80000000,890000000,4,4,왕인문화 축제2018
2018,전남,월출산 국화축제,1093000000,0,1093000000,10,11,월출산 국화축제2018
2018,전남,제57회 전라남도체육대회 지원,1308842540,300000000,1008842540,4,4,제57회 전라남도체육대회 지원2018
2018,전남,함평나비대축제,977834000,799637000,178197000,4,5,함평나비대축제2018
2018,전남,대한민국 국향대전,616504000,715281000,-98777000,10,11,대한민국 국향대전2018
2018,전남,"제15회 전국1,2학년 대학축구선수권대회",309988217,0,309988217,7,7,"제15회 전국1,2학년 대학축구선수권대회2018"
2018,전남,2018완도장보고수산물축제,785000000,0,785000000,5,5,2018완도장보고수산물축제2018
2018,전남,진도신비의바닷길축제,770437140,0,770437140,5,5,진도신비의바닷길축제2018
2018,경북,경북도민생활체육대회,563686120,0,563686120,9,9,경북도민생활체육대회2018
2018,경북,세계지방정부문화관광축제(글로벌청년페스티벌),1000000000,0,1000000000,9,9,세계지방정부문화관광축제(글로벌청년페스티벌)2018
2018,경북,경북도민체육대회,2404117540,0,2404117540,4,4,경북도민체육대회2018
2018,경북,국제불빛축제,800000000,60000000,740000000,7,7,국제불빛축제2018
2018,경북,K리그 U18 챔피언십대회,300000000,0,300000000,7,8,K리그 U18 챔피언십대회2018
2018,경북,나라사랑해병대예비역한마음행사,461328220,290000000,171328220,10,10,나라사랑해병대예비역한마음행사2018
2018,경북,칠포재즈페스티벌,500000000,290000000,210000000,9,9,칠포재즈페스티벌2018
2018,경북,포항 K-POP 콘서트,480000000,180000000,300000000,10,10,포항 K-POP 콘서트2018
2018,경북,대한민국 국제해양레저위크,400000000,200000000,200000000,8,8,대한민국 국제해양레저위크2018
2018,경북,2018 포항스틸아트페스티벌,1060000000,460000000,600000000,9,10,2018 포항스틸아트페스티벌2018
2018,경북,화랑대기 전국초등학교 유소년축구대회,1095000000,0,1095000000,8,8,화랑대기 전국초등학교 유소년축구대회2018
2018,경북,동아일보 경주국제마라톤대회,695766340,0,695766340,10,10,동아일보 경주국제마라톤대회2018
2018,경북,경주국제 유소년축구대회,737205000,0,737205000,8,8,경주국제 유소년축구대회2018
2018,경북,김천국제가족연극제,319996700,70000000,249996700,7,7,김천국제가족연극제2018
2018,경북,김천자두포도축제,448849770,0,448849770,7,7,김천자두포도축제2018
2018,경북,안동민속축제,337000000,0,337000000,9,10,안동민속축제2018
2018,경북,K-뮤지컬 이육사,333000000,0,333000000,8,8,K-뮤지컬 이육사2018
2018,경북,실경뮤지컬 왕의나라,550000000,0,550000000,10,10,실경뮤지컬 왕의나라2018
2018,경북,안동국제탈춤페스티벌,1540000000,1540000000,0,9,10,안동국제탈춤페스티벌2018
2018,경북,안동시민체육대축전,782900510,0,782900510,10,10,안동시민체육대축전2018
2018,경북,마이스터 대전,349919010,250000000,99919010,11,11,마이스터 대전2018
2018,경북,영주풍기인삼축제,740000000,20000000,720000000,10,10,영주풍기인삼축제2018
2018,경북,영주시민 체육대회,353920710,0,353920710,9,10,영주시민 체육대회2018
2018,경북,선비문화축제,540000000,40000000,500000000,5,5,선비문화축제2018
2018,경북,제6회 경상북도평생학습박람회-2018영주,360000000,180000000,180000000,10,10,제6회 경상북도평생학습박람회-2018영주2018
2018,경북,영천보현산별빛축제,337358240,0,337358240,10,10,영천보현산별빛축제2018
2018,경북,영천한약축제,481400000,0,481400000,10,10,영천한약축제2018
2018,경북,2018상주이야기축제,622227700,40000000,582227700,10,10,2018상주이야기축제2018
2018,경북,문경전통찻사발축제,1123725000,1000000000,123725000,4,5,문경전통찻사발축제2018
2018,경북,문경사과축제,410000000,0,410000000,10,10,문경사과축제2018
2018,경북,제23회 경산시민의 날 기념 체육대회,499311000,0,499311000,10,10,제23회 경산시민의 날 기념 체육대회2018
2018,경북,의성세계연축제,347320000,150000000,197320000,5,5,의성세계연축제2018
2018,경북,의성슈퍼푸드마늘축제,771575000,4579000,766996000,10,10,의성슈퍼푸드마늘축제2018
2018,경북,군민체육대회개최,410483000,0,410483000,1,12,군민체육대회개최2018
2018,경북,청송아이스클라이밍월드컵,700000000,0,700000000,1,1,청송아이스클라이밍월드컵2018
2018,경북,청송도깨비축제,510000000,0,510000000,11,11,청송도깨비축제2018
2018,경북,영양산나물축제,440000000,0,440000000,5,5,영양산나물축제2018
2018,경북,영양고추 H.O.T Festival,395289900,0,395289900,9,9,영양고추 H.O.T Festival2018
2018,경북,영덕대게축제,640000000,0,640000000,3,3,영덕대게축제2018
2018,경북,"전국,도단위 체육대회 출전",334428000,0,334428000,1,12,"전국,도단위 체육대회 출전2018"
2018,경북,한국중등(U-15) 축구대회 개최,460000000,0,460000000,1,2,한국중등(U-15) 축구대회 개최2018
2018,경북,MBC 꿈나무 축구대회 개최,380000000,0,380000000,2,2,MBC 꿈나무 축구대회 개최2018
2018,경북,청도반시축제,424000000,0,424000000,10,10,청도반시축제2018
2018,경북,청도세계코미디아트페스티벌,644520000,0,644520000,10,10,청도세계코미디아트페스티벌2018
2018,경북,대가야체험축제,1376548000,0,1376548000,4,4,대가야체험축제2018
2018,경북,성주생명문화축제,950000000,0,950000000,5,5,성주생명문화축제2018
2018,경북,창작뮤지컬제작,400000000,0,400000000,5,5,창작뮤지컬제작2018
2018,경북,6.25전쟁 62주년 낙동강지구 전투 전승기념행사,450000000,225000000,225000000,10,10,6.25전쟁 62주년 낙동강지구 전투 전승기념행사2018
2018,경북,낙동강세계평화 문화 대축전,1795242530,1041240660,754001870,10,10,낙동강세계평화 문화 대축전2018
2018,경북,봉화은어축제,1475114560,0,1475114560,7,8,봉화은어축제2018
2018,경북,봉화송이축제,466480030,0,466480030,9,10,봉화송이축제2018
2018,경북,군민체육대회,395098410,0,395098410,10,10,군민체육대회2018
2018,경북,울진워터피아 페스티벌,414000000,0,414000000,7,8,울진워터피아 페스티벌2018
2018,경북,코리아컵 국제요트대회,400000000,0,400000000,10,10,코리아컵 국제요트대회2018
2018,경북,춘계 한국 중등축구연맹전,450000000,0,450000000,1,2,춘계 한국 중등축구연맹전2018
2018,경남,국제조선해양산업전,991882380,0,991882380,1,12,국제조선해양산업전2018
2018,경남,코리아드라마페스티벌,1050000000,0,1050000000,10,10,코리아드라마페스티벌2018
2018,경남,진해군항제,654963760,0,654963760,4,4,진해군항제2018
2018,경남,진해군악의장페스티벌,446325800,0,446325800,4,4,진해군악의장페스티벌2018
2018,경남,마산가고파 국화축제,1138980600,40000000,1098980600,10,11,마산가고파 국화축제2018
2018,경남,경남도민체육대회 개최,500000000,0,500000000,4,4,경남도민체육대회 개최2018
2018,경남,한국국제기계박람회,333397899,308128415,25269484,10,10,한국국제기계박람회2018
2018,경남,창원조각비엔날레,1664416970,0,1664416970,9,10,창원조각비엔날레2018
2018,경남,장애인체육 활성화 지원,378893000,0,378893000,1,12,장애인체육 활성화 지원2018
2018,경남,제23차 세계한인경제인대회,400000000,100000000,300000000,10,11,제23차 세계한인경제인대회2018
2018,경남,창원K-POP월드페스티벌,1000000000,0,1000000000,10,10,창원K-POP월드페스티벌2018
2018,경남,2018창원방문의 해 기념 'KBS열린음악회',374306150,0,374306150,4,4,2018창원방문의 해 기념 'KBS열린음악회'2018
2018,경남,2018창원세계사격선수권대회,12170882247,0,12170882247,8,9,2018창원세계사격선수권대회2018
2018,경남,ISSF 월드컵사격대회,569745746,0,569745746,4,4,ISSF 월드컵사격대회2018
2018,경남,코리아 드라마 페스티벌,900000000,800000000,100000000,10,10,코리아 드라마 페스티벌2018
2018,경남,진주 논개제,525565650,0,525565650,5,5,진주 논개제2018
2018,경남,개천예술제,1110435320,20000000,1090435320,10,10,개천예술제2018
2018,경남,진주국제농식품박람회,1785651987,769222930,1016429057,11,11,진주국제농식품박람회2018
2018,경남,진주남강유등축제,1832000000,20000000,1812000000,10,10,진주남강유등축제2018
2018,경남,10월 축제 교통통제 및 셔틀버스 지원,679687940,0,679687940,10,10,10월 축제 교통통제 및 셔틀버스 지원2018
2018,경남,제57회 경상남도민체육대회,2140016028,40000000,2100016028,4,4,제57회 경상남도민체육대회2018
2018,경남,이순신장군배 국제요트대회,495505304,0,495505304,11,11,이순신장군배 국제요트대회2018
2018,경남,통영 ITU 트라이애슬론 월드컵,314034000,0,314034000,10,10,통영 ITU 트라이애슬론 월드컵2018
2018,경남,통영국제음악제,1623457297,0,1623457297,3,4,통영국제음악제2018
2018,경남,윤이상국제음악콩쿠르,513644749,0,513644749,10,11,윤이상국제음악콩쿠르2018
2018,경남,통영연극예술축제,328398880,130000000,198398880,7,7,통영연극예술축제2018
2018,경남,전국춘계대학축구연맹전,440000000,30000000,410000000,2,2,전국춘계대학축구연맹전2018
2018,경남,통영한산대첩축제,1114367512,0,1114367512,8,8,통영한산대첩축제2018
2018,경남,와룡문화제,390000000,0,390000000,4,4,와룡문화제2018
2018,경남,경남사천 항공우주 엑스포,1182644719,0,1182644719,10,10,경남사천 항공우주 엑스포2018
2018,경남,김해시민체육대회,600000000,0,600000000,10,10,김해시민체육대회2018
2018,경남,김해분청도자기축제,363307500,0,363307500,10,10,김해분청도자기축제2018
2018,경남,가야문화축제,1195684330,19983000,1175701330,4,5,가야문화축제2018
2018,경남,김해 문화재 야행,395517300,256784815,138732485,9,9,김해 문화재 야행2018
2018,경남,경남생활체육대축전,1167023820,20000000,1147023820,9,9,경남생활체육대축전2018
2018,경남,2018 대한민국 독서대전,640000000,240000000,400000000,8,9,2018 대한민국 독서대전2018
2018,경남,밀양아리랑대축제,2115391460,120000000,1995391460,5,5,밀양아리랑대축제2018
2018,경남,밀양여름공연예술축제,490000000,0,490000000,10,10,밀양여름공연예술축제2018
2018,경남,해양스포츠 바다로세계로,516000000,0,516000000,7,7,해양스포츠 바다로세계로2018
2018,경남,거제섬꽃축제,290041070,110409000,179632070,10,11,거제섬꽃축제2018
2018,경남,양산삽량문화축전,566882480,20000000,546882480,10,10,양산삽량문화축전2018
2018,경남,의병제전,555000000,20000000,535000000,4,4,의병제전2018
2018,경남,보물섬 마늘축제,399256680,0,399256680,6,6,보물섬 마늘축제2018
2018,경남,하동야생차문화축제,525000000,0,525000000,5,5,하동야생차문화축제2018
2018,경남,알프스하동섬진강재첩축제,350000000,0,350000000,7,7,알프스하동섬진강재첩축제2018
2018,경남,산청한방약초축제,2034511832,400000000,1634511832,9,10,산청한방약초축제2018
2018,경남,함양산삼축제,1037757670,20000000,1017757670,9,9,함양산삼축제2018
2018,경남,거창한마당 대축제,786000000,0,786000000,9,9,거창한마당 대축제2018
2018,경남,대야문화제,513000000,0,513000000,9,9,대야문화제2018
2018,제주,제주 들불축제,1688149440,0,1688149440,3,3,제주 들불축제2018
2018,제주,제주감귤박람회,2256479420,768997554,1487481866,11,12,제주감귤박람회2018
2018,제주,제주국제관악제 개최,1463626068,0,1463626068,10,10,제주국제관악제 개최2018
2018,제주,제주특별자치도민체육대회,1500000000,0,1500000000,4,4,제주특별자치도민체육대회2018
2018,제주,세계 리더스 보전 포럼,696625000,0,696625000,10,10,세계 리더스 보전 포럼2018
2018,제주,제주포럼,2840000000,609000000,2231000000,6,6,제주포럼2018
2018,제주,제주유채꽃축제,739088000,0,739088000,4,4,제주유채꽃축제2018
2018,제주,the cj 컵 나인브릿지 골프대회,800000000,0,800000000,10,10,the cj 컵 나인브릿지 골프대회2018
2018,제주,탐라문화제,1199844430,0,1199844430,10,10,탐라문화제2018
2018,제주,국제전기자동차엑스포,600000000,0,600000000,5,5,국제전기자동차엑스포2018
2018,제주,선도농업인대회,567168434,273361417,293807017,9,9,선도농업인대회2018
2018,제주,제주코리아 태권도 선수권대회,500000000,0,500000000,7,7,제주코리아 태권도 선수권대회2018
2019,서울,서울특별시장기 생활체육대회,670164000,0,670164000,1,12,서울특별시장기 생활체육대회2019
2019,서울,서울빛초롱 축제(등 축제),821783870,0,821783870,11,11,서울빛초롱 축제(등 축제)2019
2019,서울,연등 축제(연등회 행사 지원),900000000,0,900000000,4,5,연등 축제(연등회 행사 지원)2019
2019,서울,서울 뮤직페스티벌,1500000000,0,1500000000,9,10,서울 뮤직페스티벌2019
2019,서울,왕궁수문장 교대의식 재현,2903000000,0,2903000000,1,12,왕궁수문장 교대의식 재현2019
2019,서울,남산 봉수의식 등 전통문화 행사,759188340,0,759188340,1,12,남산 봉수의식 등 전통문화 행사2019
2019,서울,광화문ㆍ뚝섬 나눔장터 운영,713366630,0,713366630,3,10,광화문ㆍ뚝섬 나눔장터 운영2019
2019,서울,서울국제만화애니메이션페스티벌,570000000,0,570000000,7,7,서울국제만화애니메이션페스티벌2019
2019,서울,서울김장문화제,930012510,0,930012510,11,11,서울김장문화제2019
2019,서울,서울국제관광산업박람회,880000000,0,880000000,6,6,서울국제관광산업박람회2019
2019,서울,문화가 흐르는 서울광장 행사,975300000,0,975300000,4,10,문화가 흐르는 서울광장 행사2019
2019,서울,서울정원박람회,1592390930,0,1592390930,10,10,서울정원박람회2019
2019,서울,서울거리공연 운영,970000000,0,970000000,4,11,서울거리공연 운영2019
2019,서울,도심권 차없는 거리 문화행사,689000000,0,689000000,4,10,도심권 차없는 거리 문화행사2019
2019,서울,한강몽땅 여름축제,1267312957,0,1267312957,7,8,한강몽땅 여름축제2019
2019,서울,정조대왕 능행차 재현 행사,1121407430,0,1121407430,10,10,정조대왕 능행차 재현 행사2019
2019,서울,서울밤도깨비 야시장,2345999136,0,2345999136,4,10,서울밤도깨비 야시장2019
2019,서울,스타트업 서울 2019 : Tech-Rise (구 서울창업박람회),974403000,0,974403000,9,9,스타트업 서울 2019 : Tech-Rise (구 서울창업박람회)2019
2019,서울,이태원지구촌축제,345000000,0,345000000,10,10,이태원지구촌축제2019
2019,서울,서울장미축제,581857120,0,581857120,5,5,서울장미축제2019
2019,서울,마포나루 새우젓축제,542178870,0,542178870,10,10,마포나루 새우젓축제2019
2019,서울,허준 축제,384555000,70000000,314555000,10,10,허준 축제2019
2019,서울,구로문화 축제,415000000,0,415000000,9,9,구로문화 축제2019
2019,서울,구로 아시아 문화축제 개최,320000000,0,320000000,9,9,구로 아시아 문화축제 개최2019
2019,서울,서울구로국제어린이영화제,548748000,250000000,298748000,5,5,서울구로국제어린이영화제2019
2019,서울,2019 영등포 여의도 봄꽃축제,412923850,180000000,232923850,4,4,2019 영등포 여의도 봄꽃축제2019
2019,서울,동작가족한마음축제,316651040,0,316651040,10,10,동작가족한마음축제2019
2019,서울,관악강감찬축제,501226650,0,501226650,10,10,관악강감찬축제2019
2019,서울,제8회 서울도시농업박람회,532016330,0,532016330,5,5,제8회 서울도시농업박람회2019
2019,서울,강남구민체육대회,362973290,0,362973290,5,5,강남구민체육대회2019
2019,서울,365일 FUN&PAN 강남,387100100,0,387100100,3,11,365일 FUN&PAN 강남2019
2019,서울,강남페스티벌,1977327450,50000000,1927327450,9,10,강남페스티벌2019
2019,서울,송파한가족 구민체육대회,300609320,0,300609320,5,5,송파한가족 구민체육대회2019
2019,서울,서울놀이마당 상설전통공연,916198985,858504100,57694885,1,12,서울놀이마당 상설전통공연2019
2019,서울,한성백제문화제,695733550,220000000,475733550,9,9,한성백제문화제2019
2019,서울,국가유공자 보훈행사,500189310,8000000,492189310,1,12,국가유공자 보훈행사2019
2019,서울,강동선사문화축제,636236000,0,636236000,10,10,강동선사문화축제2019
2019,부산,부산국제수산무역 EXPO,500000000,0,500000000,11,11,부산국제수산무역 EXPO2019
2019,부산,부산항축제,600000000,300000000,300000000,5,5,부산항축제2019
2019,부산,부산국제영화제,5050000000,0,5050000000,10,10,부산국제영화제2019
2019,부산,부산국제광고제,1325881988,515909055,809972933,8,8,부산국제광고제2019
2019,부산,부산콘텐츠마켓,1678516244,886487928,792028316,5,5,부산콘텐츠마켓2019
2019,부산,국제게임전시회 (지스타),2473916045,0,2473916045,11,11,국제게임전시회 (지스타)2019
2019,부산,부산국제연극제,564000000,160000000,404000000,5,5,부산국제연극제2019
2019,부산,부산비엔날레,1540000000,700000000,840000000,9,10,부산비엔날레2019
2019,부산,부산불꽃축제,1700000000,900000000,800000000,11,11,부산불꽃축제2019
2019,부산,부산바다축제,969815000,0,969815000,8,8,부산바다축제2019
2019,부산,부산국제록페스티벌,500000000,0,500000000,7,7,부산국제록페스티벌2019
2019,부산,조선통신사축제,530523010,0,530523010,1,12,조선통신사축제2019
2019,부산,대한민국 국제해양레저위크,714139520,519947520,194192000,8,8,대한민국 국제해양레저위크2019
2019,부산,부산국제코미디페스티벌,1199901936,599978356,599923580,8,9,부산국제코미디페스티벌2019
2019,부산,부산원아시아페스티벌,2790955641,897963820,1892991821,10,10,부산원아시아페스티벌2019
2019,부산,EAFF E-1 챔피언십,500000000,0,500000000,12,12,EAFF E-1 챔피언십2019
2019,부산,2019 한아세안특별정상회의,15608926540,4510926660,11097999880,11,11,2019 한아세안특별정상회의2019
2019,부산,드론쇼코리아,600000000,300000000,300000000,1,1,드론쇼코리아2019
2019,부산,2019 LPGA 정규투어,619622000,0,619622000,10,10,2019 LPGA 정규투어2019
2019,부산,아시아필름마켓,2000000000,1000000000,1000000000,10,10,아시아필름마켓2019
2019,부산,건강도시 조성사업,2939064100,0,2939064100,12,12,건강도시 조성사업2019
2019,부산,부산자갈치축제,309732000,0,309732000,10,10,부산자갈치축제2019
2019,부산,영도다리축제,332500000,45000000,287500000,10,10,영도다리축제2019
2019,부산,동래읍성역사축제,446460000,45000000,401460000,10,10,동래읍성역사축제2019
2019,부산,낙동강 구포나루 축제,360000000,30000000,330000000,5,5,낙동강 구포나루 축제2019
2019,부산,해운대모래축제,480000000,0,480000000,5,5,해운대모래축제2019
2019,부산,해운대 빛 축제 개최,480000000,0,480000000,11,1,해운대 빛 축제 개최2019
2019,부산,금정산성역사문화축제,360509090,149840200,210668890,5,7,금정산성역사문화축제2019
2019,부산,광안리어방축제,726262270,221262270,505000000,4,4,광안리어방축제2019
2019,대구,대구국제섬유박람회,855000000,0,855000000,3,3,대구국제섬유박람회2019
2019,대구,대구국제마라톤대회,2244587090,0,2244587090,4,4,대구국제마라톤대회2019
2019,대구,대구국제안경전,723259840,0,723259840,4,4,대구국제안경전2019
2019,대구,대구국제뮤지컬페스티벌,2349966000,450000000,1899966000,6,7,대구국제뮤지컬페스티벌2019
2019,대구,대구패션페어,700000000,350000000,350000000,3,3,대구패션페어2019
2019,대구,컬러풀대구페스티벌,1799787475,800000000,999787475,5,5,컬러풀대구페스티벌2019
2019,대구,팔공산산중전통장터(승시),600000000,300000000,300000000,10,10,팔공산산중전통장터(승시)2019
2019,대구,대구아트스퀘어,1096890192,200000000,896890192,11,11,대구아트스퀘어2019
2019,대구,대구글로벌게임문화축제,511525560,211076510,300449050,8,9,대구글로벌게임문화축제2019
2019,대구,대구국제재즈축제,550000000,220000000,330000000,9,9,대구국제재즈축제2019
2019,대구,대한민국 도시농업박람회,600000000,0,600000000,9,9,대한민국 도시농업박람회2019
2019,대구,대구치맥페스티벌,1911879081,70000000,1841879081,7,7,대구치맥페스티벌2019
2019,대구,대구국제패션문화페스티벌,537489310,220000000,317489310,4,12,대구국제패션문화페스티벌2019
2019,대구,대구포크페스티벌,745000000,280000000,465000000,7,7,대구포크페스티벌2019
2019,대구,2019 국제지구과학올림피아드 개최지원,100000000,0,100000000,8,9,2019 국제지구과학올림피아드 개최지원2019
2019,대구,대구 국제 미래자동차엑스포,1500000000,0,1500000000,10,10,대구 국제 미래자동차엑스포2019
2019,대구,기획전,682133846,0,682133846,1,10,기획전2019
2019,대구,해외교류전,660567568,0,660567568,2,12,해외교류전2019
2019,대구,전국무용제,889650360,0,889650360,9,10,전국무용제2019
2019,대구,수성못 페스티벌,304927540,0,304927540,9,9,수성못 페스티벌2019
2019,대구,수성빛예술제,564533740,0,564533740,12,1,수성빛예술제2019
2019,대구,100대 피아노콘서트,529643880,100000000,429643880,9,9,100대 피아노콘서트2019
2019,인천,펜타포트 음악축제,1061827646,0,1061827646,8,8,펜타포트 음악축제2019
2019,인천,동아시아문화도시,1021400000,0,1021400000,1,12,동아시아문화도시2019
2019,인천,개항장 컬쳐나잇,587317186,441000000,146317186,6,6,개항장 컬쳐나잇2019
2019,인천,연수능허대 문화축제,300313440,0,300313440,10,10,연수능허대 문화축제2019
2019,인천,부평풍물대축제,629655677,390000000,239655677,9,9,부평풍물대축제2019
2019,인천,정서진피크닉클래식,700000000,0,700000000,9,9,정서진피크닉클래식2019
2019,광주,광주세계김치축제,1133952100,0,1133952100,10,10,광주세계김치축제2019
2019,광주,광주디자인비엔날레,3340414964,1282201494,2058213470,9,10,광주디자인비엔날레2019
2019,광주,세계인권도시포럼,516195042,0,516195042,9,10,세계인권도시포럼2019
2019,광주,광주비엔날레,1980000000,0,1980000000,1,12,광주비엔날레2019
2019,광주,광주프린지페스티벌,1175761330,0,1175761330,4,11,광주프린지페스티벌2019
2019,광주,공연장상주단체육성지원,655920240,327960120,327960120,1,12,공연장상주단체육성지원2019
2019,광주,추억의충장축제,1435575,1170000,265575,10,10,추억의충장축제2019
2019,광주,아시아음식문화지구 조성사업,317243600,0,317243600,4,10,아시아음식문화지구 조성사업2019
2019,대전,대전국제와인페어,807011,0,807011,8,8,대전국제와인페어2019
2019,대전,대전사이언스페스티벌,1160000000,15000000,1145000000,10,10,대전사이언스페스티벌2019
2019,대전,전국 장애인 체육대회 개최 및 참가,603456000,0,603456000,1,12,전국 장애인 체육대회 개최 및 참가2019
2019,대전,세계유명미술 특별전,561036810,0,561036810,11,1,세계유명미술 특별전2019
2019,대전,대전 토토즐 페스티벌,800000000,0,800000000,5,10,대전 토토즐 페스티벌2019
2019,대전,효문화 뿌리축제,799324450,30000000,769324450,9,9,효문화 뿌리축제2019
2019,대전,대전 서구힐링 아트페스티벌,810754920,70000000,740754920,5,5,대전 서구힐링 아트페스티벌2019
2019,대전,유성구 어린이 물놀이장,352950900,0,352950900,7,8,유성구 어린이 물놀이장2019
2019,대전,2019 유성온천문화축제,921998000,0,921998000,5,5,2019 유성온천문화축제2019
2019,울산,서머페스티벌,700000000,0,700000000,7,7,서머페스티벌2019
2019,울산,한글문화예술제,570000000,0,570000000,10,10,한글문화예술제2019
2019,울산,수요열린예술무대 뒤란,583074600,76359400,506715200,2,12,수요열린예술무대 뒤란2019
2019,울산,울산마두희축제,500000000,150000000,350000000,6,6,울산마두희축제2019
2019,울산,울산고래축제,1449175340,0,1449175340,6,6,울산고래축제2019
2019,울산,구립교향악단 정기연주회,429946480,0,429946480,1,12,구립교향악단 정기연주회2019
2019,울산,울산조선해양축제,395759000,200000000,195759000,7,7,울산조선해양축제2019
2019,울산,울산쇠부리축제,591000000,200000000,391000000,5,5,울산쇠부리축제2019
2019,울산,울산옹기축제,712500000,200000000,512500000,5,5,울산옹기축제2019
2019,울산,울산진하PWA세계윈드서핑대회,530000000,150000000,380000000,5,5,울산진하PWA세계윈드서핑대회2019
2019,울산,간절곶해맞이행사,450000000,200000000,250000000,12,1,간절곶해맞이행사2019
2019,울산,울주세계산악영화제,2399971562,0,2399971562,9,9,울주세계산악영화제2019
2019,세종,세종축제,1000000000,0,1000000000,10,10,세종축제2019
2019,세종,2019 전국 종합체육대회 참가 지원,935288866,0,935288866,1,12,2019 전국 종합체육대회 참가 지원2019
2019,세종,제8회 세종시민체육대회,556842810,0,556842810,9,9,제8회 세종시민체육대회2019
2019,세종,2019 읍면동체육대회 및 한마음행사 지원,529601500,0,529601500,1,12,2019 읍면동체육대회 및 한마음행사 지원2019
2019,경기,경기국제보트쇼,1292965827,0,1292965827,5,5,경기국제보트쇼2019
2019,경기,플레이엑스포,1800000000,0,1800000000,5,5,플레이엑스포2019
2019,경기,대한민국 우수상품 전시회(G-FAIR KOREA),1500000000,0,1500000000,10,11,대한민국 우수상품 전시회(G-FAIR KOREA)2019
2019,경기,찾아가는 경기관광박람회,600000000,0,600000000,10,10,찾아가는 경기관광박람회2019
2019,경기,DMZ국제다큐영화제,2861173000,0,2861173000,9,9,DMZ국제다큐영화제2019
2019,경기,경기정원문화박람회,624492160,0,624492160,10,10,경기정원문화박람회2019
2019,경기,판교 자율주행모터쇼,1000000000,0,1000000000,11,11,판교 자율주행모터쇼2019
2019,경기,tour de DMZ 국제자전거대회 개최,885000000,292935000,592065000,8,9,tour de DMZ 국제자전거대회 개최2019
2019,경기,도민참여 활성화 프로그램,648060000,0,648060000,3,2,도민참여 활성화 프로그램2019
2019,경기,경기 환경전(Eco Fair Korea) 개최,600000000,0,600000000,10,10,경기 환경전(Eco Fair Korea) 개최2019
2019,경기,Live in DMZ,806143565,0,806143565,9,9,Live in DMZ2019
2019,경기,DMZ 세계생태평화축제,824269442,100000000,724269442,9,9,DMZ 세계생태평화축제2019
2019,경기,DMZ 포럼,891869362,0,891869362,9,9,DMZ 포럼2019
2019,경기,수원화성문화제,1671346200,162293650,1509052550,10,10,수원화성문화제2019
2019,경기,정조대왕 능행차 연시,1140618160,288049000,852569160,10,10,정조대왕 능행차 연시2019
2019,경기,정보과학축제,499000000,50000000,449000000,10,10,정보과학축제2019
2019,경기,기획전 개최,516887590,80347000,436540590,1,12,기획전 개최2019
2019,경기,수원 문화재 야행,384757280,192378640,192378640,8,8,수원 문화재 야행2019
2019,경기,수원연극축제,549421860,99550000,449871860,5,5,수원연극축제2019
2019,경기,KBS 열린음악회,313547000,0,313547000,8,8,KBS 열린음악회2019
2019,경기,경기도 체육대회,489569320,0,489569320,3,6,경기도 체육대회2019
2019,경기,성남국제의료관광컨벤션,594780100,0,594780100,9,9,성남국제의료관광컨벤션2019
2019,경기,경기도 지역대표공연예술제 지원사업 (의정부음악극축제),906000000,0,906000000,5,5,경기도 지역대표공연예술제 지원사업 (의정부음악극축제)2019
2019,경기,전국단위대회 개최 및 출전,307568210,0,307568210,1,12,전국단위대회 개최 및 출전2019
2019,경기,경기관광축제지원사업(블랙뮤직페스티벌),367884520,0,367884520,8,8,경기관광축제지원사업(블랙뮤직페스티벌)2019
2019,경기,안양시민축제,544967000,0,544967000,9,9,안양시민축제2019
2019,경기,제6회 안양공공예술축제,2659726121,0,2659726121,10,12,제6회 안양공공예술축제2019
2019,경기,복사골예술제,360000000,0,360000000,5,5,복사골예술제2019
2019,경기,부천국제판타스틱영화제,2701013160,0,2701013160,6,7,부천국제판타스틱영화제2019
2019,경기,부천국제애니메이션페스티벌,1246737480,0,1246737480,10,10,부천국제애니메이션페스티벌2019
2019,경기,부천국제만화축제,724273000,55000000,669273000,8,8,부천국제만화축제2019
2019,경기,부천 세계비보이 대회,491532000,132000000,359532000,9,9,부천 세계비보이 대회2019
2019,경기,특별기획전시(라스코 전시관 '빛의 놀이터!레인보우팩토리'),809316000,0,809316000,5,11,특별기획전시(라스코 전시관 '빛의 놀이터!레인보우팩토리')2019
2019,경기,물놀이장 운영,357476013,17290049,340185964,7,8,물놀이장 운영2019
2019,경기,안산국제거리극,1245738650,0,1245738650,5,5,안산국제거리극2019
2019,경기,종목별 체육대회 개최,546919330,0,546919330,3,12,종목별 체육대회 개최2019
2019,경기,"경기도체육대회, 경기도장애인체육대회 개폐회식",830000000,0,830000000,1,12,"경기도체육대회, 경기도장애인체육대회 개폐회식2019"
2019,경기,제30회 경기도생활체육대축전 개최,307717640,0,307717640,1,12,제30회 경기도생활체육대축전 개최2019
2019,경기,제65회 경기도체육대회 및 제9회 경기도장애인체육대회,1781102110,0,1781102110,1,12,제65회 경기도체육대회 및 제9회 경기도장애인체육대회2019
2019,경기,고양국제꽃박람회,1147647826,0,1147647826,4,5,고양국제꽃박람회2019
2019,경기,고양행주문화제,350000000,50000000,300000000,5,5,고양행주문화제2019
2019,경기,과천축제,994972260,110000000,884972260,9,9,과천축제2019
2019,경기,세계3쿠션 당구월드컵 개최,352228680,0,352228680,11,11,세계3쿠션 당구월드컵 개최2019
2019,경기,다산아트홀 공연 운영,797887710,0,797887710,4,12,다산아트홀 공연 운영2019
2019,경기,생활체육대회 개최 및 출전지원,325064740,0,325064740,2,12,생활체육대회 개최 및 출전지원2019
2019,경기,시승격 30주년 기념행사,344860270,0,344860270,5,5,시승격 30주년 기념행사2019
2019,경기,갯골축제,847635000,138000000,709635000,9,9,갯골축제2019
2019,경기,제14회 전국해양스포츠제전,1940124520,1110000000,830124520,8,8,제14회 전국해양스포츠제전2019
2019,경기,군포철쭉축제,577445710,55000000,522445710,4,4,군포철쭉축제2019
2019,경기,의왕철도축제,326524000,0,326524000,5,5,의왕철도축제2019
2019,경기,의왕백운예술제,308294540,0,308294540,9,9,의왕백운예술제2019
2019,경기,전국(도단위) 체육대회,522628000,0,522628000,12,12,전국(도단위) 체육대회2019
2019,경기,마티네콘서트,328496000,0,328496000,3,12,마티네콘서트2019
2019,경기,파주장단콩축제,494619160,0,494619160,11,11,파주장단콩축제2019
2019,경기,제7회 경기정원문화박람회,950247660,0,950247660,10,10,제7회 경기정원문화박람회2019
2019,경기,이천도자기축제,906635906,0,906635906,4,5,이천도자기축제2019
2019,경기,설봉산별빛축제,0,0,0,7,8,설봉산별빛축제2019
2019,경기,이천국제조각심포지엄,0,0,0,7,8,이천국제조각심포지엄2019
2019,경기,안성맞춤 남사당 바우덕이 축제,1117497260,255000000,862497260,10,10,안성맞춤 남사당 바우덕이 축제2019
2019,경기,햇살드리 농특산물 전시홍보판매행사,457128100,0,457128100,1,12,햇살드리 농특산물 전시홍보판매행사2019
2019,경기,예술단체지원사업,435378400,0,435378400,1,12,예술단체지원사업2019
2019,경기,화성뱃놀이축제,2196916980,168348670,2028568310,6,6,화성뱃놀이축제2019
2019,경기,세계우유의날 행사 유치,300000000,0,300000000,6,6,세계우유의날 행사 유치2019
2019,경기,광주 왕실 도자기 축제,515988000,0,515988000,4,5,광주 왕실 도자기 축제2019
2019,경기,2019 양주 천만송이 천일홍 축제,589008610,0,589008610,9,9,2019 양주 천만송이 천일홍 축제2019
2019,경기,여주도자기축제,809509000,0,809509000,4,5,여주도자기축제2019
2019,경기,연천전곡리 구석기축제,875365010,0,875365010,5,5,연천전곡리 구석기축제2019
2019,경기,양평 용문산 산나물 축제,704607000,50000000,654607000,5,5,양평 용문산 산나물 축제2019
2019,강원,평창대관령음악제,1567598000,547276000,1020322000,7,8,평창대관령음악제2019
2019,강원,GTI 국제무역 투자박람회,2194486000,900000000,1294486000,10,10,GTI 국제무역 투자박람회2019
2019,강원,드림프로그램,1399658000,700000000,699658000,1,1,드림프로그램2019
2019,강원,국제 드론스포츠대회,985633000,349700000,635933000,10,10,국제 드론스포츠대회2019
2019,강원,해외 강원도 특산품 판촉홍보전,560535000,0,560535000,1,12,해외 강원도 특산품 판촉홍보전2019
2019,강원,대한민국 탄소 포럼,590000000,0,590000000,9,9,대한민국 탄소 포럼2019
2019,강원,평화지역 상설 문화공연,2800000000,0,2800000000,1,12,평화지역 상설 문화공연2019
2019,강원,남북강원도 PEACE WEEK(2019 평창평화포럼),1300000000,0,1300000000,2,2,남북강원도 PEACE WEEK(2019 평창평화포럼)2019
2019,강원,2018평창동계올림픽 및 패럴림픽 1주년 기념행사,1074747000,0,1074747000,2,3,2018평창동계올림픽 및 패럴림픽 1주년 기념행사2019
2019,강원,평창남북평화영화제,1700000000,0,1700000000,8,8,평창남북평화영화제2019
2019,강원,대관령겨울음악제,585694000,0,585694000,2,2,대관령겨울음악제2019
2019,강원,평화지역 문화예술 축제행사 지원,2500000000,0,2500000000,1,12,평화지역 문화예술 축제행사 지원2019
2019,강원,DMZ 세계평화예술축제(DMZ World ART FESTA),995000000,0,995000000,9,10,DMZ 세계평화예술축제(DMZ World ART FESTA)2019
2019,강원,평화 청춘 프린지 페스티벌,700000000,0,700000000,1,12,평화 청춘 프린지 페스티벌2019
2019,강원,춘천마임축제,719427440,119600000,599827440,5,6,춘천마임축제2019
2019,강원,춘천인형극제,547903072,190000000,357903072,9,10,춘천인형극제2019
2019,강원,춘천향토음식축제,514628570,0,514628570,6,6,춘천향토음식축제2019
2019,강원,춘천가족음악축제,399961349,199987764,199973585,9,9,춘천가족음악축제2019
2019,강원,올림픽 세계불꽃축제(제1회 춘천세계불꽃축제+춘천평화문화축전),573641700,-90406399,664048099,2,2,올림픽 세계불꽃축제(제1회 춘천세계불꽃축제+춘천평화문화축전)2019
2019,강원,장난감축제(토이페스티벌),400000000,0,400000000,10,10,장난감축제(토이페스티벌)2019
2019,강원,춘천연극제,370000000,140000000,230000000,6,6,춘천연극제2019
2019,강원,춘천 강변가요제(SBS),399057210,199528605,199528605,10,10,춘천 강변가요제(SBS)2019
2019,강원,춘천 레저대회,500000000,0,500000000,9,9,춘천 레저대회2019
2019,강원,원주시농업인날 삼토문화제,499985425,0,499985425,10,10,원주시농업인날 삼토문화제2019
2019,강원,원주다이내믹댄싱카니발,1894086789,0,1894086789,9,9,원주다이내믹댄싱카니발2019
2019,강원,강릉 단오제,1557903504,379200000,1178703504,6,6,강릉 단오제2019
2019,강원,강릉커피축제,440000000,91000000,349000000,10,10,강릉커피축제2019
2019,강원,경포썸머페스티벌,349998600,0,349998600,7,8,경포썸머페스티벌2019
2019,강원,문화재 야행,587724999,440793749,146931250,8,9,문화재 야행2019
2019,강원,강릉국제영화제,1731058587,0,1731058587,11,11,강릉국제영화제2019
2019,강원,제12회 한국수산업경영인 전국대회,399917800,199958900,199958900,5,5,제12회 한국수산업경영인 전국대회2019
2019,강원,동해무릉제,536200586,0,536200586,10,10,동해무릉제2019
2019,강원,태백산눈축제,1272739000,50000000,1222739000,1,2,태백산눈축제2019
2019,강원,전국추계대학축구연맹전,384000000,0,384000000,8,8,전국추계대학축구연맹전2019
2019,강원,"한강,낙동강 발원지축제",942856720,612856868,329999852,7,8,"한강,낙동강 발원지축제2019"
2019,강원,실향민문화축제 지원,410000000,0,410000000,5,6,실향민문화축제 지원2019
2019,강원,기줄다리기와 함께하는 삼척정월대보름제,576321030,0,576321030,2,2,기줄다리기와 함께하는 삼척정월대보름제2019
2019,강원,삼척 황영조 국제마라톤대회,349974000,0,349974000,4,4,삼척 황영조 국제마라톤대회2019
2019,강원,치어업 삼척 스포츠문화 관광산업 육성 프로젝트,596693588,450000000,146693588,8,9,치어업 삼척 스포츠문화 관광산업 육성 프로젝트2019
2019,강원,홍천강 별빛음악맥주축제,444154624,0,444154624,7,7,홍천강 별빛음악맥주축제2019
2019,강원,홍천강 꽁꽁축제,1491767965,0,1491767965,1,1,홍천강 꽁꽁축제2019
2019,강원,횡성한우축제,2134683980,0,2134683980,10,10,횡성한우축제2019
2019,강원,동강국제사진제,547081000,0,547081000,7,9,동강국제사진제2019
2019,강원,단종문화제,974100000,0,974100000,4,4,단종문화제2019
2019,강원,김삿갓문화제,383000000,0,383000000,9,9,김삿갓문화제2019
2019,강원,강원도소년체육대회,450000000,0,450000000,4,4,강원도소년체육대회2019
2019,강원,오대산문화축전,400000000,0,400000000,10,10,오대산문화축전2019
2019,강원,평창송어축제,140000000,91000000,49000000,12,2,평창송어축제2019
2019,강원,평창효석문화제,696400000,119600000,576800000,9,9,평창효석문화제2019
2019,강원,2019 평창세계문화오픈대회,999993201,0,999993201,10,10,2019 평창세계문화오픈대회2019
2019,강원,2019 평창 세계태권도한마당,815673189,0,815673189,7,7,2019 평창 세계태권도한마당2019
2019,강원,"대한민국 아리랑 대축제, 정선아리랑제",722601450,0,722601450,10,10,"대한민국 아리랑 대축제, 정선아리랑제2019"
2019,강원,전국 5일장 박람회,570000000,0,570000000,9,9,전국 5일장 박람회2019
2019,강원,철원화강 다슬기축제,960292190,0,960292190,8,8,철원화강 다슬기축제2019
2019,강원,한탄강 얼음트레킹행사,695700040,0,695700040,1,1,한탄강 얼음트레킹행사2019
2019,강원,DMZ 피스트레인 뮤직페스티벌,1499878159,0,1499878159,6,6,DMZ 피스트레인 뮤직페스티벌2019
2019,강원,얼음나라 화천 산천어 축제,5268486000,3053558000,2214928000,1,1,얼음나라 화천 산천어 축제2019
2019,강원,물의 나라 화천 쪽배 축제,512277000,44929000,467348000,7,8,물의 나라 화천 쪽배 축제2019
2019,강원,화천 토마토 축제,611302500,12500000,598802500,8,8,화천 토마토 축제2019
2019,강원,배꼽축제,435000000,0,435000000,8,8,배꼽축제2019
2019,강원,빙어축제,1749305760,0,1749305760,1,2,빙어축제2019
2019,강원,만해축전,560000000,0,560000000,8,8,만해축전2019
2019,강원,인제군 군장병 한마음대회,329787000,0,329787000,10,10,인제군 군장병 한마음대회2019
2019,강원,양양 송이 축제,529753860,26409879,503343981,9,9,양양 송이 축제2019
2019,강원,양양 연어 축제,671342940,75627134,595715806,10,10,양양 연어 축제2019
2019,강원,양양문화제,534978860,0,534978860,6,6,양양문화제2019
2019,강원,2019 양양 서핑 페스티벌,390152000,0,390152000,9,10,2019 양양 서핑 페스티벌2019
2019,충북,솔라페스티벌,824674240,15000000,809674240,9,9,솔라페스티벌2019
2019,충북,중국인유학생페스티벌,996656477,400000000,596656477,9,9,중국인유학생페스티벌2019
2019,충북,오송화장품뷰티산업엑스포,2650000000,0,2650000000,10,10,오송화장품뷰티산업엑스포2019
2019,충북,세계무예마스터십,13310592470,0,13310592470,8,9,세계무예마스터십2019
2019,충북,충주세계무술축제,1095033700,0,1095033700,8,9,충주세계무술축제2019
2019,충북,제천국제음악영화제,2480000000,500000000,1980000000,8,8,제천국제음악영화제2019
2019,충북,제천한방바이오박람회,1491917660,5272722,1486644938,10,10,제천한방바이오박람회2019
2019,충북,청원생명축제,2499941760,44715167,2455226593,9,10,청원생명축제2019
2019,충북,(청주)청주국제공예비엔날레,4821273622,1400000000,3421273622,10,11,(청주)청주국제공예비엔날레2019
2019,충북,세종대왕과 초정약수 축제,574774260,30000000,544774260,5,6,세종대왕과 초정약수 축제2019
2019,충북,청원생명축제 지원,411814070,0,411814070,9,10,청원생명축제 지원2019
2019,충북,2019 대한민국 독서대전,679960350,400000000,279960350,8,9,2019 대한민국 독서대전2019
2019,충북,제8회 대한민국 도시농업박람회,477582200,0,477582200,5,5,제8회 대한민국 도시농업박람회2019
2019,충북,청주문화재야행,552717977,420000000,132717977,8,10,청주문화재야행2019
2019,충북,보은대추축제,911732000,0,911732000,10,10,보은대추축제2019
2019,충북,속리산 신(神)축제,398282000,0,398282000,5,5,속리산 신(神)축제2019
2019,충북,지용제,326000000,0,326000000,5,5,지용제2019
2019,충북,향수옥천 포도복숭아 축제,421753470,0,421753470,7,7,향수옥천 포도복숭아 축제2019
2019,충북,영동난계국악축제,1110000000,160000000,950000000,10,10,영동난계국악축제2019
2019,충북,영동포도축제,859531000,0,859531000,8,9,영동포도축제2019
2019,충북,제10회 대한민국 와인축제,454993220,0,454993220,10,10,제10회 대한민국 와인축제2019
2019,충북,솔라 페스티벌,828206890,0,828206890,9,9,솔라 페스티벌2019
2019,충북,괴산고추축제,991815790,0,991815790,8,9,괴산고추축제2019
2019,충북,음성품바축제,738025000,140000000,598025000,5,5,음성품바축제2019
2019,충북,음성인삼축제,332599000,0,332599000,9,9,음성인삼축제2019
2019,충북,소백산철쭉제,450000000,0,450000000,5,5,소백산철쭉제2019
2019,충북,온달문화축제,550000000,0,550000000,10,10,온달문화축제2019
2019,충북,증평인삼골축제,349000000,0,349000000,10,10,증평인삼골축제2019
2019,충남,백제문화제,1780000000,0,1780000000,9,10,백제문화제2019
2019,충남,천안흥타령춤축제,2537534464,350000000,2187534464,9,9,천안흥타령춤축제2019
2019,충남,천안시민체육대회,873187860,0,873187860,9,9,천안시민체육대회2019
2019,충남,백제문화제,3097835000,0,3097835000,9,10,백제문화제2019
2019,충남,석장리세계구석기축제(기반시설조성 및 체험프로그램운영),431450350,0,431450350,5,5,석장리세계구석기축제(기반시설조성 및 체험프로그램운영)2019
2019,충남,석장리 구석기 축제,600000000,119970187,480029813,5,5,석장리 구석기 축제2019
2019,충남,공주 문화재 야행,513755500,0,513755500,5,8,공주 문화재 야행2019
2019,충남,보령머드축제,2892180000,0,2892180000,7,7,보령머드축제2019
2019,충남,성웅이순신축제,744456920,0,744456920,4,4,성웅이순신축제2019
2019,충남,서산시민체육대회,300000000,0,300000000,10,10,서산시민체육대회2019
2019,충남,서산해미읍성축제,900000000,0,900000000,10,10,서산해미읍성축제2019
2019,충남,논산딸기축제,825967990,40000000,785967990,3,3,논산딸기축제2019
2019,충남,계룡군문화축제,2286076000,650000000,1636076000,10,10,계룡군문화축제2019
2019,충남,기지시줄다리기 민속축제,579530000,100000000,479530000,4,4,기지시줄다리기 민속축제2019
2019,충남,부여서동연꽃축제,1300000000,0,1300000000,7,7,부여서동연꽃축제2019
2019,충남,백제문화제,2850000000,0,2850000000,9,10,백제문화제2019
2019,충남,문화재야행,279539380,0,279539380,7,7,문화재야행2019
2019,충남,한산모시문화제,1193000000,110000000,1083000000,6,6,한산모시문화제2019
2019,충남,선셋장항페스티벌,965717002,0,965717002,10,10,선셋장항페스티벌2019
2019,충남,제71회 충청남도민체육대회,1656255000,0,1656255000,5,5,제71회 충청남도민체육대회2019
2019,충남,청양 고추구기자축제,635177680,0,635177680,8,9,청양 고추구기자축제2019
2019,충남,홍성역사인물축제,624287450,0,624287450,9,9,홍성역사인물축제2019
2019,충남,윤봉길평화축제,304021420,0,304021420,4,4,윤봉길평화축제2019
2019,전북,전주세계소리축제,2156869900,360000000,1796869900,10,10,전주세계소리축제2019
2019,전북,전주국제발효식품엑스포,957000000,0,957000000,10,10,전주국제발효식품엑스포2019
2019,전북,전라북도 브랜드 공연,536201530,0,536201530,1,12,전라북도 브랜드 공연2019
2019,전북,도지사기 등 종목별체육대회,658791850,0,658791850,1,12,도지사기 등 종목별체육대회2019
2019,전북,제48회 전국소년체육대회,2918119120,0,2918119120,5,5,제48회 전국소년체육대회2019
2019,전북,제13회 전국장애학생체육대회,1193203440,0,1193203440,5,5,제13회 전국장애학생체육대회2019
2019,전북,전주국제영화제,4316900000,1116900000,3200000000,5,5,전주국제영화제2019
2019,전북,전주비빔밥축제,500000000,50000000,450000000,10,10,전주비빔밥축제2019
2019,전북,전주대사습놀이 전국대회,440000000,290000000,150000000,6,6,전주대사습놀이 전국대회2019
2019,전북,전주얼티밋 뮤직페스티벌,300000000,0,300000000,8,8,전주얼티밋 뮤직페스티벌2019
2019,전북,전주문화재 야행,480000000,312000000,168000000,5,10,전주문화재 야행2019
2019,전북,군산새만금국제마라톤,940000000,400000000,540000000,4,4,군산새만금국제마라톤2019
2019,전북,금석배 전국학생 축구대회,700000000,140000000,560000000,2,2,금석배 전국학생 축구대회2019
2019,전북,군산시간여행축제,637788680,30000000,607788680,10,10,군산시간여행축제2019
2019,전북,군산야행,783994250,509600000,274394250,8,8,군산야행2019
2019,전북,익산서동축제,728545000,30000000,698545000,5,5,익산서동축제2019
2019,전북,익산천만송이국화축제,963299431,0,963299431,10,11,익산천만송이국화축제2019
2019,전북,익산 문화재야행,353999400,0,353999400,4,10,익산 문화재야행2019
2019,전북,정읍구절초축제,465203800,50000000,415203800,10,10,정읍구절초축제2019
2019,전북,2019 설날장사씨름대회,365183900,30000000,335183900,2,2,2019 설날장사씨름대회2019
2019,전북,춘향제,1212000000,310000000,902000000,5,5,춘향제2019
2019,전북,남원 코리아오픈 국제롤러 경기대회,320000000,5000000,315000000,4,4,남원 코리아오픈 국제롤러 경기대회2019
2019,전북,광한루 600년 기념행사 및 한여름밤 남원 막걸리 축제,328629490,0,328629490,8,8,광한루 600년 기념행사 및 한여름밤 남원 막걸리 축제2019
2019,전북,김제지평선축제,2299000000,0,2299000000,9,10,김제지평선축제2019
2019,전북,완주와일드푸드축제,740877810,7956000,732921810,9,9,완주와일드푸드축제2019
2019,전북,진안홍삼축제,850000000,0,850000000,10,10,진안홍삼축제2019
2019,전북,무주반딧불축제,2376270290,0,2376270290,8,9,무주반딧불축제2019
2019,전북,무주산골영화제,680000000,0,680000000,6,6,무주산골영화제2019
2019,전북,임실N치즈축제,842440000,410000000,432440000,10,10,임실N치즈축제2019
2019,전북,순창장류축제,849992431,150000000,699992431,10,10,순창장류축제2019
2019,전북,세계소스박람회,316253000,129411000,186842000,10,10,세계소스박람회2019
2019,전북,모양성제,860000000,150000000,710000000,10,10,모양성제2019
2019,전북,부안마실축제,906075000,205000000,701075000,5,5,부안마실축제2019
2019,전남,남도음식문화큰잔치,757669990,0,757669990,10,10,남도음식문화큰잔치2019
2019,전남,명량대첩축제,1300000000,0,1300000000,9,9,명량대첩축제2019
2019,전남,국수산맥 국제바둑대회 개최,970000000,0,970000000,6,9,국수산맥 국제바둑대회 개최2019
2019,전남,전남 GT(그랜드투어링),630000000,0,630000000,9,9,전남 GT(그랜드투어링)2019
2019,전남,국제 철인3종경기대회,600000000,0,600000000,9,9,국제 철인3종경기대회2019
2019,전남,2019국제농업박람회,7164752000,2010000000,5154752000,10,10,2019국제농업박람회2019
2019,전남,목포항구축제,615000000,30000000,585000000,10,10,목포항구축제2019
2019,전남,목포문화재야행,329418750,0,329418750,9,9,목포문화재야행2019
2019,전남,제1회 전라남도혁신박람회,393861450,0,393861450,9,9,제1회 전라남도혁신박람회2019
2019,전남,섬의 날 행사 추진,699904090,0,699904090,8,8,섬의 날 행사 추진2019
2019,전남,여수거북선축제,848350000,0,848350000,5,5,여수거북선축제2019
2019,전남,경로위안잔치,399984420,0,399984420,10,11,경로위안잔치2019
2019,전남,여수밤바다 불꽃축제,395773600,0,395773600,10,10,여수밤바다 불꽃축제2019
2019,전남,순천만세계동물영화제 개최,722910510,0,722910510,8,8,순천만세계동물영화제 개최2019
2019,전남,항꾼에 즐기는 아고라순천 문화예술 행사,638464006,0,638464006,3,12,항꾼에 즐기는 아고라순천 문화예술 행사2019
2019,전남,순천만국가정원 물빛축제,335830000,0,335830000,7,8,순천만국가정원 물빛축제2019
2019,전남,순천 문화재 야행,581378760,0,581378760,4,4,순천 문화재 야행2019
2019,전남,순천만국제교향악축제,498404000,0,498404000,9,9,순천만국제교향악축제2019
2019,전남,정원 월드투어 페스타,531186240,0,531186240,5,5,정원 월드투어 페스타2019
2019,전남,2019 순천푸드앤아트페스티벌,600000000,20000000,580000000,9,9,2019 순천푸드앤아트페스티벌2019
2019,전남,2019도시재생한마당,600000000,0,600000000,10,10,2019도시재생한마당2019
2019,전남,순천방문의 해,1610675831,0,1610675831,1,12,순천방문의 해2019
2019,전남,KOVO컵 프로배구대회,865446051,100000000,765446051,9,10,KOVO컵 프로배구대회2019
2019,전남,제6회 대한민국 한평정원 페스티벌,463075000,0,463075000,9,10,제6회 대한민국 한평정원 페스티벌2019
2019,전남,2019 대한민국 균형발전박람회 in 전남·순천,950614080,0,950614080,9,9,2019 대한민국 균형발전박람회 in 전남·순천2019
2019,전남,마한문화축제,590000000,0,590000000,10,10,마한문화축제2019
2019,전남,광양매화축제,318518320,0,318518320,3,3,광양매화축제2019
2019,전남,담양대나무축제,734250000,170000000,564250000,5,5,담양대나무축제2019
2019,전남,제9회 곡성세계장미축제,410000000,980650000,-570650000,5,5,제9회 곡성세계장미축제2019
2019,전남,구례산수유꽃축제,450000000,0,450000000,3,3,구례산수유꽃축제2019
2019,전남,국제철인3종경기,1381117273,400000000,981117273,9,9,국제철인3종경기2019
2019,전남,고흥 유자 석류축제,624184985,0,624184985,10,11,고흥 유자 석류축제2019
2019,전남,서편제보성소리축제,410000000,0,410000000,5,5,서편제보성소리축제2019
2019,전남,보성차밭빛축제,930000000,0,930000000,11,1,보성차밭빛축제2019
2019,전남,보성다향대축제,870000000,0,870000000,5,5,보성다향대축제2019
2019,전남,율포해변 활어잡기 페스티벌,358003585,0,358003585,5,8,율포해변 활어잡기 페스티벌2019
2019,전남,화순군 농업인 한마음대회,0,0,0,11,11,화순군 농업인 한마음대회2019
2019,전남,2019 화순 국화향연,853263110,0,853263110,10,11,2019 화순 국화향연2019
2019,전남,치매안심센터운영지원,718131253,0,718131253,1,12,치매안심센터운영지원2019
2019,전남,정남진장흥물축제,1500000000,0,1500000000,7,8,정남진장흥물축제2019
2019,전남,대한민국통합의학박람회,999857000,0,999857000,10,10,대한민국통합의학박람회2019
2019,전남,대한민국 산림문화 박람회,1056330807,0,1056330807,10,10,대한민국 산림문화 박람회2019
2019,전남,강진청자축제,1265500000,0,1265500000,10,10,강진청자축제2019
2019,전남,강진만 춤추는 갈대축제,475000000,0,475000000,10,11,강진만 춤추는 갈대축제2019
2019,전남,남도음식문화큰잔치,566991104,0,566991104,10,10,남도음식문화큰잔치2019
2019,전남,농수산물 먹거리축제,600000000,0,600000000,10,11,농수산물 먹거리축제2019
2019,전남,왕인문화 축제,980000000,70000000,910000000,4,4,왕인문화 축제2019
2019,전남,월출산 국화축제,439346000,0,439346000,10,11,월출산 국화축제2019
2019,전남,제27회 전라남도장애인체육대회,569149300,100000000,469149300,5,5,제27회 전라남도장애인체육대회2019
2019,전남,추석장사씨름대회,420000000,0,420000000,9,9,추석장사씨름대회2019
2019,전남,제31회 전라남도생활체육대축전,684476990,149816650,534660340,10,10,제31회 전라남도생활체육대축전2019
2019,전남,무안연꽃축제,587034960,55041000,531993960,7,7,무안연꽃축제2019
2019,전남,황토갯벌축제,349078380,23379000,325699380,6,6,황토갯벌축제2019
2019,전남,함평나비대축제,890901000,954698000,-63797000,4,5,함평나비대축제2019
2019,전남,대한민국 국향대전,739088000,979963000,-240875000,10,11,대한민국 국향대전2019
2019,전남,영광 e-모빌리티 엑스포,1770000000,0,1770000000,9,9,영광 e-모빌리티 엑스포2019
2019,전남,제19회 영광불갑산상사화축제,391963070,0,391963070,9,9,제19회 영광불갑산상사화축제2019
2019,전남,2019완도장보고수산물축제,784830000,0,784830000,5,5,2019완도장보고수산물축제2019
2019,전남,진도신비의바닷길축제,753979120,0,753979120,3,3,진도신비의바닷길축제2019
2019,경북,경북사과 홍보행사,500000000,0,500000000,11,11,경북사과 홍보행사2019
2019,경북,경북도민생활체육대회,744895830,0,744895830,9,9,경북도민생활체육대회2019
2019,경북,경북도민체육대회,2557980210,0,2557980210,4,4,경북도민체육대회2019
2019,경북,2019경주세계문화엑스포,6000000000,0,6000000000,10,11,2019경주세계문화엑스포2019
2019,경북,국제불빛축제,940000000,140000000,800000000,5,6,국제불빛축제2019
2019,경북,나라사랑해병대예비역한마음행사,494737950,143230000,351507950,4,4,나라사랑해병대예비역한마음행사2019
2019,경북,칠포재즈페스티벌,350000000,145000000,205000000,9,9,칠포재즈페스티벌2019
2019,경북,포항 K-POP 콘서트,560000000,280000000,280000000,9,9,포항 K-POP 콘서트2019
2019,경북,대한민국 국제해양레저위크,400000000,200000000,200000000,7,9,대한민국 국제해양레저위크2019
2019,경북,2019 포항스틸아트페스티벌,1135000000,435000000,700000000,9,9,2019 포항스틸아트페스티벌2019
2019,경북,포항 70년 미술관 10년 포항시립미술관 개관기념특별전 제로 ZERO,582411369,0,582411369,9,1,포항 70년 미술관 10년 포항시립미술관 개관기념특별전 제로 ZERO2019
2019,경북,K-리그 유스챔피언십대회,300000000,0,300000000,7,8,K-리그 유스챔피언십대회2019
2019,경북,화랑대기 전국초등학교 유소년축구대회,1126596000,30000000,1096596000,8,8,화랑대기 전국초등학교 유소년축구대회2019
2019,경북,동아일보 경주국제마라톤대회,1234034000,200000000,1034034000,10,10,동아일보 경주국제마라톤대회2019
2019,경북,경주국제 유소년축구대회,554903411,0,554903411,8,8,경주국제 유소년축구대회2019
2019,경북,경북도민체육대회,300000000,0,300000000,4,4,경북도민체육대회2019
2019,경북,김천국제가족연극제,450000000,0,450000000,7,7,김천국제가족연극제2019
2019,경북,김천자두포도축제,515570200,0,515570200,7,7,김천자두포도축제2019
2019,경북,2019 김천시민체육대회,958284260,0,958284260,10,10,2019 김천시민체육대회2019
2019,경북,안동민속축제,337000000,0,337000000,9,10,안동민속축제2019
2019,경북,K-뮤지컬 이육사,333000000,0,333000000,8,8,K-뮤지컬 이육사2019
2019,경북,실경뮤지컬 왕의나라,600000000,0,600000000,8,9,실경뮤지컬 왕의나라2019
2019,경북,안동국제탈춤페스티벌,1000000000,0,1000000000,9,10,안동국제탈춤페스티벌2019
2019,경북,안동시민체육대축전,774130290,0,774130290,4,4,안동시민체육대축전2019
2019,경북,대한민국 정수대전,306761060,114776000,191985060,4,12,대한민국 정수대전2019
2019,경북,마이스터 대전,349933480,249952490,99980990,11,11,마이스터 대전2019
2019,경북,구미공단 50주년 기념식,318338625,90726508,227612117,9,9,구미공단 50주년 기념식2019
2019,경북,영주풍기인삼축제,950000000,5000000,945000000,10,10,영주풍기인삼축제2019
2019,경북,영주시민 체육대회,384100000,0,384100000,8,11,영주시민 체육대회2019
2019,경북,선비문화축제,640000000,0,640000000,5,5,선비문화축제2019
2019,경북,영천보현산별빛축제,397024900,0,397024900,6,6,영천보현산별빛축제2019
2019,경북,영천한약축제,585100000,0,585100000,9,9,영천한약축제2019
2019,경북,영천시민체육대회,592328750,0,592328750,4,4,영천시민체육대회2019
2019,경북,상주농업기계박람회,900000000,0,900000000,4,4,상주농업기계박람회2019
2019,경북,문경전통찻사발축제,1180000000,940000000,240000000,4,5,문경전통찻사발축제2019
2019,경북,문경사과축제,360000000,0,360000000,10,10,문경사과축제2019
2019,경북,제29회 경북도민생활체육대축전,744895830,0,744895830,9,9,제29회 경북도민생활체육대축전2019
2019,경북,제57회 경북도민체육대회,2557980210,1700000000,857980210,4,4,제57회 경북도민체육대회2019
2019,경북,의성세계연축제,449717000,6694000,443023000,5,5,의성세계연축제2019
2019,경북,의성슈퍼푸드마늘축제,821500000,3368000,818132000,10,10,의성슈퍼푸드마늘축제2019
2019,경북,경상북도 평생학습박람회,517480000,0,517480000,10,10,경상북도 평생학습박람회2019
2019,경북,WCT 의성국제컬링컵대회,489019000,0,489019000,9,10,WCT 의성국제컬링컵대회2019
2019,경북,청송사과축제,610000000,0,610000000,10,11,청송사과축제2019
2019,경북,청송아이스클라이밍월드컵,692000000,0,692000000,1,1,청송아이스클라이밍월드컵2019
2019,경북,영양산나물축제,540000000,0,540000000,5,5,영양산나물축제2019
2019,경북,영양고추 H.O.T Festival,397897000,0,397897000,8,8,영양고추 H.O.T Festival2019
2019,경북,영덕대게축제,740000000,140000000,600000000,3,3,영덕대게축제2019
2019,경북,"전국,도단위 체육대회 출전",346763200,0,346763200,1,12,"전국,도단위 체육대회 출전2019"
2019,경북,국제단위 체육대회 개최(도비보조),560000000,180000000,380000000,8,8,국제단위 체육대회 개최(도비보조)2019
2019,경북,한국중등(U-15) 축구대회 개최,910000000,10000000,900000000,1,12,한국중등(U-15) 축구대회 개최2019
2019,경북,청도소싸움축제,530000000,0,530000000,5,5,청도소싸움축제2019
2019,경북,청도반시축제,427876330,0,427876330,10,10,청도반시축제2019
2019,경북,청도세계코미디아트페스티벌,639619400,0,639619400,10,10,청도세계코미디아트페스티벌2019
2019,경북,대가야체험축제,1250225000,0,1250225000,4,4,대가야체험축제2019
2019,경북,성주생명문화축제 성주참외페스티벌,1150000000,0,1150000000,5,5,성주생명문화축제 성주참외페스티벌2019
2019,경북,낙동강지구 전투 전승기념행사,433628000,216814000,216814000,10,10,낙동강지구 전투 전승기념행사2019
2019,경북,낙동강세계평화 문화 대축전,1792805990,1039827460,752978530,10,10,낙동강세계평화 문화 대축전2019
2019,경북,예천세계활축제,800000000,165994436,634005564,10,10,예천세계활축제2019
2019,경북,봉화은어축제,2031275630,0,2031275630,7,8,봉화은어축제2019
2019,경북,봉화송이축제,538851000,0,538851000,9,9,봉화송이축제2019
2019,경북,국립백두대간수목원 봉자 페스티벌,500000000,150000000,350000000,7,10,국립백두대간수목원 봉자 페스티벌2019
2019,경북,춘계 한국 중등축구연맹전,300425000,0,300425000,2,2,춘계 한국 중등축구연맹전2019
2019,경북,추계 한국중등축구 연맹전,295000000,0,295000000,8,8,추계 한국중등축구 연맹전2019
2019,경남,도지사배 PAV경연대회,645130850,0,645130850,10,10,도지사배 PAV경연대회2019
2019,경남,코리아드라마페스티벌,1000000000,0,1000000000,10,10,코리아드라마페스티벌2019
2019,경남,진해군항제,794913557,0,794913557,4,4,진해군항제2019
2019,경남,진해군악의장페스티벌,488579500,0,488579500,4,4,진해군악의장페스티벌2019
2019,경남,경남도민체육대회 개최,500000000,0,500000000,4,4,경남도민체육대회 개최2019
2019,경남,장애인체육 활성화 지원,378893000,170454500,208438500,1,12,장애인체육 활성화 지원2019
2019,경남,창원K-POP월드페스티벌,1000000000,0,1000000000,4,12,창원K-POP월드페스티벌2019
2019,경남,ISSF 월드컵사격대회,349280176,0,349280176,5,5,ISSF 월드컵사격대회2019
2019,경남,마산국화축제,1153988190,15000000,1138988190,10,11,마산국화축제2019
2019,경남,2019 창원국제스마트팩토리 및 생산제조기술전,327884050,252764742,75119308,10,11,2019 창원국제스마트팩토리 및 생산제조기술전2019
2019,경남,코리아 드라마 페스티벌,1000000000,800000000,200000000,10,10,코리아 드라마 페스티벌2019
2019,경남,진주 논개제,600069000,0,600069000,5,5,진주 논개제2019
2019,경남,개천예술제,1276190140,55000000,1221190140,10,10,개천예술제2019
2019,경남,진주국제농식품박람회,1874242623,687399750,1186842873,11,11,진주국제농식품박람회2019
2019,경남,진주남강유등축제,2499864208,99975000,2399889208,10,10,진주남강유등축제2019
2019,경남,10월 축제 교통통제 및 셔틀버스 지원,716336510,0,716336510,10,10,10월 축제 교통통제 및 셔틀버스 지원2019
2019,경남,제30회 경상남도생활체육대축전,1315996000,18400000,1297596000,10,10,제30회 경상남도생활체육대축전2019
2019,경남,이순신장군배 국제요트대회,646518339,0,646518339,11,11,이순신장군배 국제요트대회2019
2019,경남,통영 ITU 트라이애슬론 월드컵,590000000,310000000,280000000,10,10,통영 ITU 트라이애슬론 월드컵2019
2019,경남,통영국제음악제,1209603620,0,1209603620,3,4,통영국제음악제2019
2019,경남,윤이상국제음악콩쿠르,134621734,0,134621734,10,11,윤이상국제음악콩쿠르2019
2019,경남,전국춘계대학축구연맹전,460000000,30000000,430000000,2,2,전국춘계대학축구연맹전2019
2019,경남,통영한산대첩축제,1209000000,0,1209000000,8,8,통영한산대첩축제2019
2019,경남,문화재 야행사업,539967810,0,539967810,3,10,문화재 야행사업2019
2019,경남,와룡문화제,461292069,0,461292069,4,4,와룡문화제2019
2019,경남,사천에어쇼,1263708094,0,1263708094,10,10,사천에어쇼2019
2019,경남,제17회 사천시민체육대회,300000000,0,300000000,10,10,제17회 사천시민체육대회2019
2019,경남,가야문화축제,1069772850,14500000,1055272850,4,4,가야문화축제2019
2019,경남,김해 문화재 야행,316894430,205981380,110913050,9,9,김해 문화재 야행2019
2019,경남,밀양아리랑대축제,2217352000,0,2217352000,5,5,밀양아리랑대축제2019
2019,경남,밀양여름공연예술축제,700000000,31244440,668755560,7,8,밀양여름공연예술축제2019
2019,경남,나노피아 국제콘퍼런스 및 전시회,349732170,0,349732170,11,11,나노피아 국제콘퍼런스 및 전시회2019
2019,경남,해양스포츠 바다로세계로,506000000,0,506000000,8,8,해양스포츠 바다로세계로2019
2019,경남,거제섬꽃축제,306588321,192650500,113937821,10,11,거제섬꽃축제2019
2019,경남,문화예술단체 지원,316297000,0,316297000,3,12,문화예술단체 지원2019
2019,경남,양산삽량문화축전,734812620,15000000,719812620,10,10,양산삽량문화축전2019
2019,경남,양산웅상회야제,389431280,400000000,-10568720,5,5,양산웅상회야제2019
2019,경남,의병제전,640000000,15000000,625000000,4,4,의병제전2019
2019,경남,보물섬 마늘축제,440643040,0,440643040,6,6,보물섬 마늘축제2019
2019,경남,하동야생차문화축제,701687000,0,701687000,5,5,하동야생차문화축제2019
2019,경남,알프스하동섬진강재첩축제,348786000,0,348786000,7,7,알프스하동섬진강재첩축제2019
2019,경남,산청한방약초축제,2167000000,467000000,1700000000,9,10,산청한방약초축제2019
2019,경남,함양산삼축제,1047443840,15000000,1032443840,9,9,함양산삼축제2019
2019,경남,거창한마당 대축제,779020080,0,779020080,9,9,거창한마당 대축제2019
2019,경남,대야문화제,530000000,0,530000000,9,9,대야문화제2019
2019,제주,제주 들불축제,1629022750,2411000,1626611750,3,3,제주 들불축제2019
2019,제주,서귀포 칠십리축제,698099000,0,698099000,9,9,서귀포 칠십리축제2019
2019,제주,제주감귤박람회,995845760,103965440,891880320,11,11,제주감귤박람회2019
2019,제주,제주국제관악제 개최,1500000000,0,1500000000,8,8,제주국제관악제 개최2019
2019,제주,제주특별자치도민체육대회,1500000000,0,1500000000,4,4,제주특별자치도민체육대회2019
2019,제주,제주포럼,2870000000,673000000,2197000000,5,5,제주포럼2019
2019,제주,삼다공원 야간 힐링콘서트,573900569,0,573900569,4,8,삼다공원 야간 힐링콘서트2019
2019,제주,the cj 컵 나인브릿지 골프대회,800000000,0,800000000,10,10,the cj 컵 나인브릿지 골프대회2019
2019,제주,탐라문화제,1275000000,0,1275000000,10,10,탐라문화제2019
2019,제주,글로벌4-H 한마음대회,723800000,0,723800000,9,9,글로벌4-H 한마음대회2019
2020,서울,서울 뮤직페스티벌(서울×음악여행),1514000000,0,1514000000,10,12,서울 뮤직페스티벌(서울×음악여행)2020
2020,서울,왕궁수문장 교대의식 재현,2899464800,0,2899464800,1,12,왕궁수문장 교대의식 재현2020
2020,서울,남산 봉수의식 등 전통문화 행사,797050000,0,797050000,1,12,남산 봉수의식 등 전통문화 행사2020
2020,서울,서울국제만화애니메이션페스티벌(SICAF),570000000,0,570000000,11,11,서울국제만화애니메이션페스티벌(SICAF)2020
2020,서울,서울국제트래블마트(관광산업박람회),836700000,0,836700000,11,11,서울국제트래블마트(관광산업박람회)2020
2020,서울,문화가 흐르는 서울광장 행사,724400000,0,724400000,9,12,문화가 흐르는 서울광장 행사2020
2020,서울,서울 365 거리공연 운영,1329750000,0,1329750000,8,12,서울 365 거리공연 운영2020
2020,서울,자문밖 창의예술마을 조성,141213127,0,141213127,3,12,자문밖 창의예술마을 조성2020
2020,서울,불광천 일대 온라인 프로그램 지원사업 '힘내라 은평! 오늘 그리고 내일',378270000,0,378270000,10,10,불광천 일대 온라인 프로그램 지원사업 '힘내라 은평! 오늘 그리고 내일'2020
2020,서울,서울구로국제어린이영화제,607266900,250000000,357266900,7,7,서울구로국제어린이영화제2020
2020,서울,서울영등포국제초단편영화제,550000000,0,550000000,6,12,서울영등포국제초단편영화제2020
2020,서울,국제평화마라톤,345444850,0,345444850,10,10,국제평화마라톤2020
2020,서울,365일 FUN&PAN 강남,447878800,0,447878800,8,11,365일 FUN&PAN 강남2020
2020,서울,강남페스티벌,1524194900,85000000,1439194900,10,10,강남페스티벌2020
2020,서울,한성백제문화제,312661600,109072790,203588810,9,9,한성백제문화제2020
2020,서울,강동선사문화축제,460509880,0,460509880,10,10,강동선사문화축제2020
2020,부산,부산국제수산무역 EXPO,520000000,70000000,450000000,11,11,부산국제수산무역 EXPO2020
2020,부산,부산국제영화제,4539813687,0,4539813687,10,10,부산국제영화제2020
2020,부산,부산국제광고제,766604818,338519071,428085747,10,10,부산국제광고제2020
2020,부산,부산콘텐츠마켓,1298304120,733307900,564996220,11,12,부산콘텐츠마켓2020
2020,부산,국제게임전시회 (지스타),2432489662,0,2432489662,11,11,국제게임전시회 (지스타)2020
2020,부산,대한민국 국제해양레저위크,683782017,502304180,181477837,8,8,대한민국 국제해양레저위크2020
2020,부산,부산국제코미디페스티벌,1042180802,0,1042180802,1,12,부산국제코미디페스티벌2020
2020,부산,아시아필름마켓,1127149847,528212503,598937344,10,10,아시아필름마켓2020
2020,부산,제16회 대한민국 청소년박람회,538833836,0,538833836,12,12,제16회 대한민국 청소년박람회2020
2020,부산,해운대 빛 축제 개최,798749000,0,798749000,11,3,해운대 빛 축제 개최2020
2020,대구,대구지방기능경기대회,970000000,0,970000000,1,12,대구지방기능경기대회2020
2020,대구,대구국제뮤지컬페스티벌,1585841766,665575000,920266766,10,11,대구국제뮤지컬페스티벌2020
2020,대구,대구 국제 미래자동차엑스포,967760796,0,967760796,10,10,대구 국제 미래자동차엑스포2020
2020,대구,기획전,543794240,5182000,538612240,1,1,기획전2020
2020,대구,월드오케스트라시리즈,521427153,0,521427153,2,12,월드오케스트라시리즈2020
2020,대구,수성못 페스티벌,336868580,75000000,261868580,11,11,수성못 페스티벌2020
2020,대구,수성빛예술제,799993000,0,799993000,12,12,수성빛예술제2020
2020,대구,드론택시(UAM) 서비스 실증,399400000,0,399400000,11,11,드론택시(UAM) 서비스 실증2020
2020,대구,달성대구현대미술제,357479240,0,357479240,9,10,달성대구현대미술제2020
2020,인천,인천한류관광콘서트,909661330,0,909661330,10,10,인천한류관광콘서트2020
2020,인천,인천개항장문화재야행,827932519,0,827932519,11,11,인천개항장문화재야행2020
2020,광주,광주세계김치축제,651982500,197000000,454982500,11,11,광주세계김치축제2020
2020,광주,광주ACE Fair,1394586101,634536138,760049963,11,11,광주ACE Fair2020
2020,광주,세계인권도시포럼,787265791,497917086,289348705,10,10,세계인권도시포럼2020
2020,광주,광주프린지페스티벌,850538540,0,850538540,9,11,광주프린지페스티벌2020
2020,광주,중외공원활성화통합프로그램운영,600000000,0,600000000,9,10,중외공원활성화통합프로그램운영2020
2020,광주,공연장상주단체육성지원,643999290,321999645,321999645,1,12,공연장상주단체육성지원2020
2020,대전,대전비엔날레,741895700,0,741895700,9,12,대전비엔날레2020
2020,대전,대전 토토즐 페스티벌,700000000,0,700000000,10,12,대전 토토즐 페스티벌2020
2020,대전,유성국화전시회,314509070,0,314509070,10,11,유성국화전시회2020
2020,울산,한글문화예술제,570000000,0,570000000,10,10,한글문화예술제2020
2020,울산,울산쇠부리축제,420000000,170000000,250000000,10,10,울산쇠부리축제2020
2020,울산,울산옹기축제,958800000,308800000,650000000,11,11,울산옹기축제2020
2020,울산,울주세계산악영화제,1559844937,0,1559844937,10,11,울주세계산악영화제2020
2020,세종,대한민국연극제,554690029,0,554690029,10,11,대한민국연극제2020
2020,경기,대한민국 뷰티박람회,1010000000,0,1010000000,1,12,대한민국 뷰티박람회2020
2020,경기,대한민국 우수상품 전시회(G-FAIR KOREA),1127536054,0,1127536054,10,10,대한민국 우수상품 전시회(G-FAIR KOREA)2020
2020,경기,DMZ국제다큐영화제,2360758333,0,2360758333,9,9,DMZ국제다큐영화제2020
2020,경기,경기정원문화박람회,592679603,0,592679603,10,10,경기정원문화박람회2020
2020,경기,판교 자율주행모터쇼,760148530,0,760148530,10,10,판교 자율주행모터쇼2020
2020,경기,DMZ 포럼,1004332413,0,1004332413,9,9,DMZ 포럼2020
2020,경기,Let's DMZ,2637607230,0,2637607230,10,10,Let's DMZ2020
2020,경기,경기평화광장 운영,925000000,0,925000000,1,12,경기평화광장 운영2020
2020,경기,글로벌 테크놀로지 쇼 개최,960808730,0,960808730,11,11,글로벌 테크놀로지 쇼 개최2020
2020,경기,기획전 개최,526461740,44766000,481695740,5,1,기획전 개최2020
2020,경기,수원 문화재 야행,455428170,186474282,268953888,10,10,수원 문화재 야행2020
2020,경기,경기도 지역대표공연예술제 지원사업 (의정부음악극축제),514353900,0,514353900,8,8,경기도 지역대표공연예술제 지원사업 (의정부음악극축제)2020
2020,경기,전국단위 및 도단위 체육대회 출전,400000000,0,400000000,1,12,전국단위 및 도단위 체육대회 출전2020
2020,경기,부천국제판타스틱영화제,2692026940,0,2692026940,7,7,부천국제판타스틱영화제2020
2020,경기,부천국제애니메이션페스티벌,1084899000,0,1084899000,10,10,부천국제애니메이션페스티벌2020
2020,경기,부천국제만화축제,568540000,120000000,448540000,9,9,부천국제만화축제2020
2020,경기,부천 세계비보이 대회,386283000,112500000,273783000,1,12,부천 세계비보이 대회2020
2020,경기,고양가구박람회,333000000,133000000,200000000,6,6,고양가구박람회2020
2020,경기,다산아트홀 공연 운영,523903060,18211960,505691100,7,12,다산아트홀 공연 운영2020
2020,경기,갯골축제,612635150,0,612635150,9,9,갯골축제2020
2020,경기,2020 대한민국 문화의 달 파주 행사,600000000,300000000,300000000,10,10,2020 대한민국 문화의 달 파주 행사2020
2020,경기,햇살드리 농특산물 전시홍보판매행사,301521360,0,301521360,1,12,햇살드리 농특산물 전시홍보판매행사2020
2020,경기,예술단체지원사업,301700000,0,301700000,1,12,예술단체지원사업2020
2020,경기,양주문화재야행,315000000,126000000,189000000,10,10,양주문화재야행2020
2020,경기,연천전곡리 구석기축제,415285200,0,415285200,1,12,연천전곡리 구석기축제2020
2020,강원,평창대관령음악제,1198619688,0,1198619688,7,8,평창대관령음악제2020
2020,강원,GTI 국제무역 투자박람회,2475546259,0,2475546259,10,10,GTI 국제무역 투자박람회2020
2020,강원,평창평화포럼,2281317490,0,2281317490,2,2,평창평화포럼2020
2020,강원,평창국제평화영화제,2000000000,0,2000000000,6,6,평창국제평화영화제2020
2020,강원,강원국제예술제 2020 개최지원,701516425,0,701516425,10,11,강원국제예술제 2020 개최지원2020
2020,강원,평창 지구인류 포럼,799067700,0,799067700,8,8,평창 지구인류 포럼2020
2020,강원,춘천마임축제,700996492,0,700996492,7,10,춘천마임축제2020
2020,강원,춘천인형극제,535000000,100000000,435000000,1,12,춘천인형극제2020
2020,강원,춘천가족음악축제,399976012,200000000,199976012,10,10,춘천가족음악축제2020
2020,강원,춘천연극제,388879800,100000000,288879800,6,11,춘천연극제2020
2020,강원,춘천 레저대회,436682000,0,436682000,8,8,춘천 레저대회2020
2020,강원,원주다이내믹댄싱카니발,305569500,0,305569500,10,10,원주다이내믹댄싱카니발2020
2020,강원,강릉 단오제,413470910,150000000,263470910,5,11,강릉 단오제2020
2020,강원,문화재 야행,848527540,492145973,356381567,11,11,문화재 야행2020
2020,강원,강릉국제영화제,1361634000,0,1361634000,11,11,강릉국제영화제2020
2020,강원,전국추계대학축구연맹전,395000000,0,395000000,8,8,전국추계대학축구연맹전2020
2020,강원,강원국제예술제,675943560,0,675943560,1,12,강원국제예술제2020
2020,강원,횡성한우축제,1213455000,141440,1213313560,10,10,횡성한우축제2020
2020,강원,오대산문화축전,400000000,0,400000000,10,7,오대산문화축전2020
2020,강원,2020 평창세계문화오픈대회,369067134,0,369067134,11,12,2020 평창세계문화오픈대회2020
2020,강원,제17회 한국농업경영인 전국대회 지원,986800140,444053090,542747050,10,10,제17회 한국농업경영인 전국대회 지원2020
2020,강원,올림픽 평화 유스캠프,679518845,0,679518845,11,11,올림픽 평화 유스캠프2020
2020,강원,DMZ 피스트레인 뮤직페스티벌,604984659,0,604984659,7,7,DMZ 피스트레인 뮤직페스티벌2020
2020,강원,얼음나라화천 산천어축제,2590333000,0,2590333000,1,2,얼음나라화천 산천어축제2020
2020,강원,빙어축제,1749305760,0,1749305760,1,1,빙어축제2020
2020,강원,만해축전,537841627,0,537841627,4,11,만해축전2020
2020,강원,2020 강원 국제 모터 페스타,471647621,250000000,221647621,10,10,2020 강원 국제 모터 페스타2020
2020,충북,오송화장품뷰티산업엑스포,1670939000,0,1670939000,10,10,오송화장품뷰티산업엑스포2020
2020,충북,충주국제무예액션영화제,0,0,0,10,10,충주국제무예액션영화제2020
2020,충북,제천국제음악영화제,1480591770,0,1480591770,8,8,제천국제음악영화제2020
2020,충북,2020 제천-KOVO컵 프로배구대회,403291200,0,403291200,8,9,2020 제천-KOVO컵 프로배구대회2020
2020,충북,가드닝 페스티벌,0,0,0,5,5,가드닝 페스티벌2020
2020,충북,청주문화재야행,0,0,0,10,10,청주문화재야행2020
2020,충북,보은대추축제,452612550,0,452612550,10,10,보은대추축제2020
2020,충북,영동 곶감 축제,429741660,0,429741660,1,1,영동 곶감 축제2020
2020,충북,노근리70주년 기념사업,1291651820,752870000,538781820,1,12,노근리70주년 기념사업2020
2020,충북,링링동 프로젝트,344812760,0,344812760,8,12,링링동 프로젝트2020
2020,충북,괴산고추축제,345096820,0,345096820,8,9,괴산고추축제2020
2020,충남,백제문화제,1780000000,0,1780000000,9,10,백제문화제2020
2020,충남,금강자연미술비엔날레,450000000,0,450000000,2,12,금강자연미술비엔날레2020
2020,충남,백제문화제,3494912770,0,3494912770,9,10,백제문화제2020
2020,충남,공주 문화재 야행,332936222,0,332936222,10,11,공주 문화재 야행2020
2020,충남,세계유산 활용사업,495000000,0,495000000,3,11,세계유산 활용사업2020
2020,충남,보령머드축제,639966000,0,639966000,7,7,보령머드축제2020
2020,충남,강경젓갈축제,650000000,0,650000000,10,10,강경젓갈축제2020
2020,충남,2020년 문화재 야행사업 '강경 야행(타임머신타고 시간여행)',614476350,430133444,184342906,10,11,2020년 문화재 야행사업 '강경 야행(타임머신타고 시간여행)'2020
2020,충남,금산인삼축제,794257000,0,794257000,10,10,금산인삼축제2020
2020,충남,백제문화제,544160000,0,544160000,9,10,백제문화제2020
2020,충남,문화재야행,470000000,0,470000000,10,10,문화재야행2020
2020,충남,홍성 설날 장사 씨름대회,447314897,0,447314897,1,1,홍성 설날 장사 씨름대회2020
2020,전북,전주세계소리축제,1830295810,0,1830295810,9,9,전주세계소리축제2020
2020,전북,전주국제발효식품엑스포,1094859526,0,1094859526,8,12,전주국제발효식품엑스포2020
2020,전북,전주 얼티밋 뮤직 페스티벌,500000000,0,500000000,11,12,전주 얼티밋 뮤직 페스티벌2020
2020,전북,전주국제영화제,3411483077,1081483077,2330000000,5,9,전주국제영화제2020
2020,전북,전주대사습놀이 전국대회,507480450,290000000,217480450,9,10,전주대사습놀이 전국대회2020
2020,전북,전주얼티밋 뮤직페스티벌,300000000,0,300000000,11,12,전주얼티밋 뮤직페스티벌2020
2020,전북,전주문화재 야행,445897584,275500000,170397584,9,10,전주문화재 야행2020
2020,전북,군산새만금국제마라톤,640000000,0,640000000,4,4,군산새만금국제마라톤2020
2020,전북,금석배 전국학생 축구대회,300000000,50000000,250000000,8,8,금석배 전국학생 축구대회2020
2020,전북,군산야행,385000000,223300000,161700000,8,8,군산야행2020
2020,전북,익산서동축제,823117000,50000000,773117000,12,2,익산서동축제2020
2020,전북,익산 문화재야행,305275230,0,305275230,8,8,익산 문화재야행2020
2020,전북,다이로움 익산 국화전시 2020,570776540,0,570776540,10,11,다이로움 익산 국화전시 20202020
2020,전북,내장산 겨울빛축제,337409700,0,337409700,12,12,내장산 겨울빛축제2020
2020,전북,춘향제,822089610,323944200,498145410,9,9,춘향제2020
2020,전북,김제지평선축제,810024320,0,810024320,10,10,김제지평선축제2020
2020,전북,2020 국제종자박람회,446523481,178610000,267913481,10,11,2020 국제종자박람회2020
2020,전북,전국 우리술 문화축전,567273333,13891740,553381593,10,11,전국 우리술 문화축전2020
2020,전북,무주산골영화제,680000000,113600112,566399888,6,10,무주산골영화제2020
2020,전북,예방물품 지원,1082639998,0,1082639998,2,12,예방물품 지원2020
2020,전남,경로위안잔치,400000000,0,400000000,10,11,경로위안잔치2020
2020,전남,항꾼에 즐기는 아고라순천 문화예술 행사,488670060,0,488670060,4,12,항꾼에 즐기는 아고라순천 문화예술 행사2020
2020,전남,순천 문화재 야행,424678500,0,424678500,10,10,순천 문화재 야행2020
2020,전남,제7회 대한민국 한평정원 페스티벌,412434800,0,412434800,10,10,제7회 대한민국 한평정원 페스티벌2020
2020,전남,동아시아문화도시,1060411900,0,1060411900,5,11,동아시아문화도시2020
2020,전남,대한민국정원산업박람회,560297216,0,560297216,12,12,대한민국정원산업박람회2020
2020,전남,낙안읍성 전통문화 재현 및 체험,619066590,0,619066590,1,12,낙안읍성 전통문화 재현 및 체험2020
2020,전남,2021 NEXPO in Suncheon 행사,383000000,0,383000000,11,12,2021 NEXPO in Suncheon 행사2020
2020,전남,치매안심센터운영지원,633769915,533049420,100720495,1,12,치매안심센터운영지원2020
2020,전남,해남 국화향연,677927540,0,677927540,10,11,해남 국화향연2020
2020,경북,포항 K-POP 콘서트,560000000,280000000,280000000,12,12,포항 K-POP 콘서트2020
2020,경북,대한민국 국제해양레저위크,500000000,290000000,210000000,8,11,대한민국 국제해양레저위크2020
2020,경북,2020 포항스틸아트페스티벌,900000000,270000000,630000000,10,10,2020 포항스틸아트페스티벌2020
2020,경북,신라소리축제 에밀레전,300000000,150000000,150000000,11,11,신라소리축제 에밀레전2020
2020,경북,실경뮤지컬 왕의나라,533000000,0,533000000,8,8,실경뮤지컬 왕의나라2020
2020,경북,영천보현산별빛축제,235889000,0,235889000,10,11,영천보현산별빛축제2020
2020,경북,문경사과축제,360000000,0,360000000,10,10,문경사과축제2020
2020,경북,문경찻사발축제,993703503,0,993703503,12,12,문경찻사발축제2020
2020,경북,영덕대게축제,335000000,85000000,250000000,12,12,영덕대게축제2020
2020,경북,성주생명문화축제 성주참외페스티벌,683018940,0,683018940,7,8,성주생명문화축제 성주참외페스티벌2020
2020,경북,봉화은어축제,1342519540,0,1342519540,8,8,봉화은어축제2020
2020,경북,국립백두대간수목원 봉자 페스티벌,500000000,150000000,350000000,7,11,국립백두대간수목원 봉자 페스티벌2020
2020,경남,국제조선해양산업전,978944830,0,978944830,12,12,국제조선해양산업전2020
2020,경남,도지사배 PAV경연대회,545881450,0,545881450,1,12,도지사배 PAV경연대회2020
2020,경남,한국국제기계박람회,354692145,283656273,71035872,7,7,한국국제기계박람회2020
2020,경남,창원국제용접 및 절단자동화전,331163730,261808580,69355150,10,10,창원국제용접 및 절단자동화전2020
2020,경남,마산국화축제,1125080860,55000000,1070080860,10,11,마산국화축제2020
2020,경남,창원블랙데이,1639681070,0,1639681070,6,11,창원블랙데이2020
2020,경남,2020 이순신방위산업전,496575000,0,496575000,11,11,2020 이순신방위산업전2020
2020,경남,한.세계화상비즈니스위크,1484289930,0,1484289930,11,11,한.세계화상비즈니스위크2020
2020,경남,개천예술제,479588740,0,479588740,11,12,개천예술제2020
2020,경남,진주남강유등축제,849777000,64400000,785377000,11,12,진주남강유등축제2020
2020,경남,이순신장군배 국제요트대회,587773740,0,587773740,11,11,이순신장군배 국제요트대회2020
2020,경남,전국춘계대학축구연맹전,485000000,25000000,460000000,10,11,전국춘계대학축구연맹전2020
2020,경남,통영한산대첩축제,300700267,188800000,111900267,8,8,통영한산대첩축제2020
2020,경남,문화재 야행사업,0,0,0,10,10,문화재 야행사업2020
2020,경남,산청한방약초축제,556700000,0,556700000,9,9,산청한방약초축제2020
2020,경남,KB바둑리그,340000000,0,340000000,11,4,KB바둑리그2020
2020,제주,제주감귤박람회,556660470,0,556660470,11,12,제주감귤박람회2020
2020,제주,제주국제관악제 개최,672444010,0,672444010,8,8,제주국제관악제 개최2020
2020,제주,제주포럼,1827500000,705000000,1122500000,11,11,제주포럼2020
2020,제주,탐라문화제,949275450,0,949275450,10,10,탐라문화제2020
2020,제주,대한민국독서대전,726868240,272575591,454292649,9,10,대한민국독서대전2020
2022,서울,서울 뮤직페스티벌,1180000000,0,1180000000,10,10,서울 뮤직페스티벌2022
2022,서울,왕궁수문장 교대의식 재현,1915230000,0,1915230000,2,12,왕궁수문장 교대의식 재현2022
2022,서울,남산 봉수의식 등 전통문화 재현행사,690400000,0,690400000,1,12,남산 봉수의식 등 전통문화 재현행사2022
2022,서울,문화가 흐르는 예술마당,700000000,0,700000000,5,12,문화가 흐르는 예술마당2022
2022,서울,서울정원박람회,915664330,0,915664330,9,10,서울정원박람회2022
2022,서울,서울 365 거리공연 운영,1106000000,0,1106000000,5,12,서울 365 거리공연 운영2022
2022,서울,한강페스티벌,1468138580,0,1468138580,7,8,한강페스티벌2022
2022,서울,정조대왕 능행차 재현 행사,634670000,0,634670000,10,10,정조대왕 능행차 재현 행사2022
2022,서울,한강달빛 야시장,1673246130,0,1673246130,8,10,한강달빛 야시장2022
2022,서울,Try Everything 2022,1788463660,0,1788463660,9,9,Try Everything 20222022
2022,서울,2022년 서울패션위크(춘계 및 추계) 행사,6314061970,0,6314061970,4,10,2022년 서울패션위크(춘계 및 추계) 행사2022
2022,서울,서울도시건축비엔날레,1079211450,0,1079211450,11,11,서울도시건축비엔날레2022
2022,서울,2022 서울라이트 광화문 빛축제,2631000000,0,2631000000,12,1,2022 서울라이트 광화문 빛축제2022
2022,서울,책 읽는 서울광장(상·하반기) 개최,1249000000,250000000,999000000,4,11,책 읽는 서울광장(상·하반기) 개최2022
2022,서울,제26차 ANOC(국가올림픽위원회연합회)총회 개최,1035728000,0,1035728000,10,10,제26차 ANOC(국가올림픽위원회연합회)총회 개최2022
2022,서울,종로 한복축제,320202927,120000000,200202927,1,12,종로 한복축제2022
2022,서울,성동문화마당,500300000,0,500300000,1,12,성동문화마당2022
2022,서울,서울장미축제,663049000,0,663049000,5,5,서울장미축제2022
2022,서울,노원혁신교육지구 사업,67073780,0,67073780,1,12,노원혁신교육지구 사업2022
2022,서울,은평 온:(On) 축제,404517000,0,404517000,11,11,은평 온:(On) 축제2022
2022,서울,마포나루 새우젓축제,549878000,55000000,494878000,10,10,마포나루 새우젓축제2022
2022,서울,구로문화 축제,459000000,0,459000000,9,9,구로문화 축제2022
2022,서울,서울구로국제어린이영화제,676308220,257967000,418341220,1,12,서울구로국제어린이영화제2022
2022,서울,서울영등포국제초단편영화제,582490824,0,582490824,10,10,서울영등포국제초단편영화제2022
2022,서울,관악강감찬축제,520000000,0,520000000,10,10,관악강감찬축제2022
2022,서울,서초금요음악회,368103240,0,368103240,1,12,서초금요음악회2022
2022,서울,나눔과 회복의 서리풀 음악회·바자회,500000000,0,500000000,9,9,나눔과 회복의 서리풀 음악회·바자회2022
2022,서울,동 지역특성문화사업 지원 ,340030170,0,340030170,1,12,동 지역특성문화사업 지원 2022
2022,서울,서울놀이마당 상설전통공연,300538655,0,300538655,3,10,서울놀이마당 상설전통공연2022
2022,서울,한성백제문화제,1310823320,220000000,1090823320,9,10,한성백제문화제2022
2022,서울,강동선사문화축제,762082690,0,762082690,10,10,강동선사문화축제2022
2022,부산,부산항축제,600000000,300000000,300000000,7,7,부산항축제2022
2022,부산,부산국제영화제,6196235000,0,6196235000,10,10,부산국제영화제2022
2022,부산,부산국제광고제,1275688704,592552868,683135836,8,8,부산국제광고제2022
2022,부산,부산콘텐츠마켓,1469355279,690906463,778448816,6,6,부산콘텐츠마켓2022
2022,부산,국제게임전시회 (지스타),2962368261,0,2962368261,11,11,국제게임전시회 (지스타)2022
2022,부산,부산불꽃축제,2320000000,0,2320000000,12,12,부산불꽃축제2022
2022,부산,부산바다축제,697843490,0,697843490,7,8,부산바다축제2022
2022,부산,부산국제록페스티벌,729987810,0,729987810,10,10,부산국제록페스티벌2022
2022,부산,조선통신사축제,873093107,0,873093107,1,12,조선통신사축제2022
2022,부산,대한민국 국제해양레저위크,893519179,512453623,381065556,8,12,대한민국 국제해양레저위크2022
2022,부산,부산국제코미디페스티벌,1592179036,0,1592179036,8,8,부산국제코미디페스티벌2022
2022,부산,부산원아시아페스티벌,2971281878,0,2971281878,10,10,부산원아시아페스티벌2022
2022,부산,피란수도 부산 문화재 야행,506631500,202652600,303978900,8,8,피란수도 부산 문화재 야행2022
2022,부산,아시아필름마켓,2000000000,1000000000,1000000000,10,10,아시아필름마켓2022
2022,부산,대한민국 지방시대 엑스포,949195970,0,949195970,11,11,대한민국 지방시대 엑스포2022
2022,부산,시민마당 운영,769483286,51812890,717670396,2,12,시민마당 운영2022
2022,부산,영도다리축제,432500000,64000000,368500000,10,10,영도다리축제2022
2022,부산,제3회 부산 희망 드림 빛축제,339658990,0,339658990,12,4,제3회 부산 희망 드림 빛축제2022
2022,부산,동래읍성역사축제,585438000,64000000,521438000,10,10,동래읍성역사축제2022
2022,부산,낙동강 구포나루 축제,378156630,23000000,355156630,10,10,낙동강 구포나루 축제2022
2022,부산,해운대모래축제,646477550,80000000,566477550,5,5,해운대모래축제2022
2022,부산,해운대 빛 축제 개최,941220000,50000000,891220000,11,1,해운대 빛 축제 개최2022
2022,부산,광안리어방축제,775000000,75000000,700000000,10,10,광안리어방축제2022
2022,부산,광안리 M 드론라이트쇼,1647143910,0,1647143910,6,5,광안리 M 드론라이트쇼2022
2022,대구,대구국제섬유박람회,725211717,0,725211717,3,3,대구국제섬유박람회2022
2022,대구,대구국제마라톤대회,1756795924,0,1756795924,4,5,대구국제마라톤대회2022
2022,대구,대구국제뮤지컬페스티벌,2867481623,953333134,1914148489,6,7,대구국제뮤지컬페스티벌2022
2022,대구,컬러풀대구페스티벌,1795502694,0,1795502694,7,7,컬러풀대구페스티벌2022
2022,대구,대구아트스퀘어,1160000000,0,1160000000,11,12,대구아트스퀘어2022
2022,대구,대구치맥페스티벌,2182259481,30000000,2152259481,7,7,대구치맥페스티벌2022
2022,대구,대구 국제 미래자동차엑스포,1781043562,0,1781043562,10,10,대구 국제 미래자동차엑스포2022
2022,대구,금호강 바람소리길 축제,319564360,0,319564360,9,9,금호강 바람소리길 축제2022
2022,대구,수성못 페스티벌,362149119,0,362149119,9,9,수성못 페스티벌2022
2022,대구,수성빛예술제,929354320,0,929354320,12,1,수성빛예술제2022
2022,대구,100대 피아노콘서트,550000000,0,550000000,10,10,100대 피아노콘서트2022
2022,대구,달성대구현대미술제,500000000,0,500000000,9,10,달성대구현대미술제2022
2022,인천,인천개항장문화재야행,1059125903,0,1059125903,9,10,인천개항장문화재야행2022
2022,인천,화도진축제,335000000,0,335000000,10,10,화도진축제2022
2022,인천,소래포구축제,678471590,100000000,578471590,10,10,소래포구축제2022
2022,인천,부평풍물대축제,599488840,200000000,399488840,9,10,부평풍물대축제2022
2022,인천,정서진피크닉클래식,490228073,0,490228073,8,9,정서진피크닉클래식2022
2022,광주,광주세계김치축제,1013233150,0,1013233150,10,10,광주세계김치축제2022
2022,광주,광주ACE Fair,1793649842,899003817,894646025,9,9,광주ACE Fair2022
2022,광주,국제광산업전시회,533039770,0,533039770,11,11,국제광산업전시회2022
2022,광주,세계인권도시포럼,549010006,0,549010006,10,10,세계인권도시포럼2022
2022,광주,광주프린지페스티벌,1284475150,0,1284475150,3,12,광주프린지페스티벌2022
2022,광주,추억의충장축제,2932100062,2000000000,932100062,10,10,추억의충장축제2022
2022,대전,대전국제와인페스티벌,890356000,90365000,799991000,8,8,대전국제와인페스티벌2022
2022,대전,대전사이언스페스티벌,1160000000,0,1160000000,10,10,대전사이언스페스티벌2022
2022,대전,2022 대전 세계지방정부연합(UCLG) 총회,5700000000,0,5700000000,10,10,2022 대전 세계지방정부연합(UCLG) 총회2022
2022,대전,대전 0시 뮤직 페스티벌,926087000,0,926087000,10,10,대전 0시 뮤직 페스티벌2022
2022,대전,대전효문화뿌리축제,815996600,16000000,799996600,10,10,대전효문화뿌리축제2022
2022,대전,2022 대전 서구힐링 아트페스티벌,760601880,15000000,745601880,10,10,2022 대전 서구힐링 아트페스티벌2022
2022,대전,유성국화전시회,474999510,0,474999510,10,10,유성국화전시회2022
2022,대전,유성구 어린이 물놀이장,419215800,0,419215800,7,8,유성구 어린이 물놀이장2022
2022,대전,2022 유성온천문화축제,550000000,0,550000000,5,5,2022 유성온천문화축제2022
2022,대전,대덕거리맥주페스티벌,353912330,0,353912330,7,9,대덕거리맥주페스티벌2022
2022,울산,서머페스티벌,700000000,0,700000000,8,8,서머페스티벌2022
2022,울산,한글문화예술제,570000000,0,570000000,10,10,한글문화예술제2022
2022,울산,울산대공원장미축제,500000000,191026000,308974000,5,5,울산대공원장미축제2022
2022,울산,수요열린예술무대 뒤란,582000000,58055920,523944080,3,12,수요열린예술무대 뒤란2022
2022,울산,제103회 전국체전 개폐회식,2924776350,1500000000,1424776350,10,10,제103회 전국체전 개폐회식2022
2022,울산,제42회 전국장애인체전 개폐회식,590100000,200000000,390100000,10,10,제42회 전국장애인체전 개폐회식2022
2022,울산,제20차 세계한상대회,832567260,0,832567260,11,11,제20차 세계한상대회2022
2022,울산,울산마두희축제,450000000,150000000,300000000,9,9,울산마두희축제2022
2022,울산,울산고래축제,1250000000,250000000,1000000000,10,10,울산고래축제2022
2022,울산,구립교향악단 정기연주회,601458000,0,601458000,1,12,구립교향악단 정기연주회2022
2022,울산,울산조선해양축제,500000000,0,500000000,7,7,울산조선해양축제2022
2022,울산,울산쇠부리축제,599927210,199975730,399951480,5,5,울산쇠부리축제2022
2022,울산,울산옹기축제,874836060,0,874836060,9,10,울산옹기축제2022
2022,울산,울주세계산악영화제,2261102382,0,2261102382,4,4,울주세계산악영화제2022
2022,울산,영남알프스 트레일러닝 대회,996000000,0,996000000,10,10,영남알프스 트레일러닝 대회2022
2022,울산,2022 울주천하장사 씨름대회,420000000,0,420000000,11,11,2022 울주천하장사 씨름대회2022
2022,세종,세종축제,899634000,0,899634000,10,10,세종축제2022
2022,세종,2022 대한민국 정원산업박람회,2000000000,500000000,1500000000,10,10,2022 대한민국 정원산업박람회2022
2022,세종,세종시민체육대회,591700000,0,591700000,9,9,세종시민체육대회2022
2022,경기,도(道)단위 생활체육대회 개최,679694000,0,679694000,8,10,도(道)단위 생활체육대회 개최2022
2022,경기,경기국제보트쇼,797953022,0,797953022,3,3,경기국제보트쇼2022
2022,경기,플레이엑스포,1409528000,199985000,1209543000,5,5,플레이엑스포2022
2022,경기,대한민국 우수상품 전시회(G-FAIR KOREA),1500000000,0,1500000000,10,10,대한민국 우수상품 전시회(G-FAIR KOREA)2022
2022,경기,DMZ국제다큐멘터리영화제,3283429000,0,3283429000,9,9,DMZ국제다큐멘터리영화제2022
2022,경기,경기정원문화박람회,600000000,0,600000000,10,10,경기정원문화박람회2022
2022,경기,경기국제웹툰페어,648274010,3610000,644664010,10,10,경기국제웹툰페어2022
2022,경기,DMZ 포럼,1130387000,0,1130387000,9,9,DMZ 포럼2022
2022,경기,Let's DMZ,2942833492,0,2942833492,9,10,Let's DMZ2022
2022,경기,경기평화광장 운영,1275028820,0,1275028820,1,12,경기평화광장 운영2022
2022,경기,퓨처 쇼 개최,674400000,0,674400000,11,11,퓨처 쇼 개최2022
2022,경기,경기 인디뮤직페스티벌,797412000,167248000,630164000,10,10,경기 인디뮤직페스티벌2022
2022,경기,수원화성문화제,1429100306,49245980,1379854326,10,10,수원화성문화제2022
2022,경기,정조대왕 능행차 연시 ,1237449251,264123441,973325810,10,10,정조대왕 능행차 연시 2022
2022,경기,기획전 개최,328779630,71343000,257436630,4,11,기획전 개최2022
2022,경기,수원 문화재 야행,565392130,233480920,331911210,8,8,수원 문화재 야행2022
2022,경기,수원연극축제,525611070,97000000,428611070,5,5,수원연극축제2022
2022,경기,국제전 개최,327413810,132150750,195263060,12,3,국제전 개최2022
2022,경기,수원화성 미디어아트쇼,2005296120,1040409060,964887060,9,10,수원화성 미디어아트쇼2022
2022,경기,2022 설날장사 씨름대회,379518000,0,379518000,1,2,2022 설날장사 씨름대회2022
2022,경기,성남국제의료관광컨벤션,646228915,0,646228915,10,10,성남국제의료관광컨벤션2022
2022,경기,생물서식처 복원사업,573701109,4271300,569429809,3,12,생물서식처 복원사업2022
2022,경기,경기도 지역대표공연예술제 지원사업(의정부음악극축제),595983245,0,595983245,6,6,경기도 지역대표공연예술제 지원사업(의정부음악극축제)2022
2022,경기,어린이도서관 독서진흥 행사 운영,162320433,0,162320433,1,12,어린이도서관 독서진흥 행사 운영2022
2022,경기,경기관광축제지원사업(블랙뮤직페스티벌),426539058,0,426539058,10,10,경기관광축제지원사업(블랙뮤직페스티벌)2022
2022,경기,전국단위 및 도단위 체육대회 출전,400174410,0,400174410,3,6,전국단위 및 도단위 체육대회 출전2022
2022,경기,의정부미술도서관 운영,597144017,0,597144017,1,12,의정부미술도서관 운영2022
2022,경기,안양시민축제,671170000,0,671170000,9,9,안양시민축제2022
2022,경기,복사골예술제,354574180,0,354574180,9,9,복사골예술제2022
2022,경기,부천국제판타스틱영화제,3299999397,0,3299999397,7,7,부천국제판타스틱영화제2022
2022,경기,부천국제애니메이션페스티벌,1217671552,0,1217671552,10,10,부천국제애니메이션페스티벌2022
2022,경기,부천국제만화축제,494486717,80000000,414486717,9,10,부천국제만화축제2022
2022,경기,부천 세계비보이 대회,473700000,93000000,380700000,9,10,부천 세계비보이 대회2022
2022,경기,위드코로나 일상회복 문화백신 기획공연,354164000,0,354164000,10,10,위드코로나 일상회복 문화백신 기획공연2022
2022,경기,한가락페스타,425553460,0,425553460,10,10,한가락페스타2022
2022,경기,안산국제거리극,555285660,60000000,495285660,5,5,안산국제거리극2022
2022,경기,고양가구박람회,478971190,0,478971190,6,6,고양가구박람회2022
2022,경기,고양행주문화제,426764470,0,426764470,6,6,고양행주문화제2022
2022,경기,과천축제,1115704420,75000000,1040704420,9,9,과천축제2022
2022,경기,남양주 정약용문화제,314810570,80000000,234810570,9,9,남양주 정약용문화제2022
2022,경기,다산아트홀 공연 운영,353000000,97893410,255106590,2,12,다산아트홀 공연 운영2022
2022,경기,오산 독산성문화제,583146750,60000000,523146750,10,10,오산 독산성문화제2022
2022,경기,경기정원문화박람회,1208884347,0,1208884347,10,10,경기정원문화박람회2022
2022,경기,전국(도단위) 체육대회,428817000,0,428817000,1,12,전국(도단위) 체육대회2022
2022,경기,협회별 대회 개최,402975000,0,402975000,1,12,협회별 대회 개최2022
2022,경기,2022 경기도종합체육대회 개최,1156962530,968106610,188855920,8,8,2022 경기도종합체육대회 개최2022
2022,경기,2022 대한민국 도시혁신 산업박람회,1094807000,0,1094807000,10,10,2022 대한민국 도시혁신 산업박람회2022
2022,경기,파주개성인삼축제,490000000,0,490000000,10,10,파주개성인삼축제2022
2022,경기,파주장단콩축제,656045000,0,656045000,11,11,파주장단콩축제2022
2022,경기,설봉산별빛축제,376000000,0,376000000,7,8,설봉산별빛축제2022
2022,경기,읍면동체육행사,387495860,0,387495860,10,10,읍면동체육행사2022
2022,경기,제35회 이천도자기축제,576101740,0,576101740,9,10,제35회 이천도자기축제2022
2022,경기,안성맞춤 남사당 바우덕이 축제,1678590000,0,1678590000,9,10,안성맞춤 남사당 바우덕이 축제2022
2022,경기,정조효문화제,909950000,0,909950000,10,10,정조효문화제2022
2022,경기,예술단체지원사업,408100140,0,408100140,1,12,예술단체지원사업2022
2022,경기,화성뱃놀이축제,1585820939,0,1585820939,9,9,화성뱃놀이축제2022
2022,경기,전국 및 국제 규모 스포츠 대회 개최 및 출전,752247240,0,752247240,1,12,전국 및 국제 규모 스포츠 대회 개최 및 출전2022
2022,경기,정조대왕능행차(화성구간),489905120,0,489905120,10,10,정조대왕능행차(화성구간)2022
2022,경기,광주 왕실 도자기 축제,654320000,0,654320000,8,9,광주 왕실 도자기 축제2022
2022,경기,양주 회암사지 왕실축제,390860800,0,390860800,10,10,양주 회암사지 왕실축제2022
2022,경기,양주 천만송이 천일홍 축제,529859000,0,529859000,9,9,양주 천만송이 천일홍 축제2022
2022,경기,양주문화재야행,354160000,0,354160000,9,9,양주문화재야행2022
2022,경기,여주도자기축제,717279000,0,717279000,4,4,여주도자기축제2022
2022,경기,여주오곡나루축제,904781000,0,904781000,10,10,여주오곡나루축제2022
2022,경기,연천전곡리 구석기축제,869497780,45000000,824497780,10,10,연천전곡리 구석기축제2022
2022,경기,자라섬 국제재즈페스티벌,400000000,0,400000000,10,10,자라섬 국제재즈페스티벌2022
2022,경기,자라섬 꽃 축제,969288010,0,969288010,1,12,자라섬 꽃 축제2022
2022,경기,양평 용문산 산나물 축제,478994000,60000000,418994000,4,4,양평 용문산 산나물 축제2022
2022,강원,평창대관령음악제,1541232000,0,1541232000,7,7,평창대관령음악제2022
2022,강원,GTI 국제무역 투자박람회,973495908,0,973495908,9,3,GTI 국제무역 투자박람회2022
2022,강원,Tour de DMZ 국제자전거 대회,617716000,0,617716000,8,8,Tour de DMZ 국제자전거 대회2022
2022,강원,평창평화포럼,2477462952,0,2477462952,2,2,평창평화포럼2022
2022,강원,평창국제평화영화제,1790945480,0,1790945480,6,6,평창국제평화영화제2022
2022,강원,강원국제예술제 개최지원,857941000,404093,857536907,9,11,강원국제예술제 개최지원2022
2022,강원,평창장애포럼,500000000,0,500000000,3,3,평창장애포럼2022
2022,강원,노벨평화상 수상자 월드서밋 강원,1429525760,0,1429525760,12,12,노벨평화상 수상자 월드서밋 강원2022
2022,강원,춘천마임축제,621424029,0,621424029,5,5,춘천마임축제2022
2022,강원,춘천향토음식축제,512765800,0,512765800,8,9,춘천향토음식축제2022
2022,강원,장난감축제(토이페스티벌),342965200,0,342965200,10,10,장난감축제(토이페스티벌)2022
2022,강원,춘천연극제,437811650,0,437811650,6,10,춘천연극제2022
2022,강원,온세대 합창페스티벌,502610000,0,502610000,8,9,온세대 합창페스티벌2022
2022,강원,춘천 조각(공공미술) 심포지엄,500000000,0,500000000,10,10,춘천 조각(공공미술) 심포지엄2022
2022,강원,2022 춘천 아비아마 총회 및 축제,2775329322,35908926,2739420396,1,12,2022 춘천 아비아마 총회 및 축제2022
2022,강원,2022 아시아태권도선수권대회,2031028152,1020000000,1011028152,6,6,2022 아시아태권도선수권대회2022
2022,강원,2022 춘천코리아오픈국제태권도대회,1443083556,0,1443083556,6,7,2022 춘천코리아오픈국제태권도대회2022
2022,강원,대한민국 독서대전,756700760,283763161,472937599,1,12,대한민국 독서대전2022
2022,강원,강변가요제,590000000,0,590000000,9,9,강변가요제2022
2022,강원,강릉 단오제,1222641880,400000000,822641880,5,6,강릉 단오제2022
2022,강원,강릉관광브랜드공연(관광거점도시),1226000000,796900000,429100000,7,12,강릉관광브랜드공연(관광거점도시)2022
2022,강원,미디어퍼포먼스(관광거점도시),800000000,520000000,280000000,7,12,미디어퍼포먼스(관광거점도시)2022
2022,강원,동해무릉제,0,0,0,9,9,동해무릉제2022
2022,강원,향교서원 문화재 활용사업,0,0,0,1,12,향교서원 문화재 활용사업2022
2022,강원,제74회 세계3쿠션 당구선수권대회 및 전국당구대회,394560000,0,394560000,11,11,제74회 세계3쿠션 당구선수권대회 및 전국당구대회2022
2022,강원,전국추계대학축구연맹전,495000000,0,495000000,8,8,전국추계대학축구연맹전2022
2022,강원,"전국 1,2학년 전국대학축구연맹전",321640000,0,321640000,7,7,"전국 1,2학년 전국대학축구연맹전2022"
2022,강원,속초 썸머 페스티벌,337222000,0,337222000,8,8,속초 썸머 페스티벌2022
2022,강원,삼척동해왕이사부축제,417835470,0,417835470,12,12,삼척동해왕이사부축제2022
2022,강원,제30회 강원도민생활체육대회,955190280,0,955190280,9,9,제30회 강원도민생활체육대회2022
2022,강원,홍천강 별빛음악맥주축제,755557080,0,755557080,8,8,홍천강 별빛음악맥주축제2022
2022,강원,홍천강 꽁꽁축제,1499004278,0,1499004278,1,1,홍천강 꽁꽁축제2022
2022,강원,강원 홍천 인삼·한우 명품축제,483564804,0,483564804,9,10,강원 홍천 인삼·한우 명품축제2022
2022,강원,2022 도시재창조 한마당 행사,637300000,0,637300000,8,9,2022 도시재창조 한마당 행사2022
2022,강원,읍면 화합의 한마당,327127530,0,327127530,5,12,읍면 화합의 한마당2022
2022,강원,동강국제사진제,671000000,0,671000000,7,10,동강국제사진제2022
2022,강원,단종문화제,1064000000,0,1064000000,4,5,단종문화제2022
2022,강원,김삿갓문화제,545000000,0,545000000,9,10,김삿갓문화제2022
2022,강원,동강뗏목축제,779000000,0,779000000,7,7,동강뗏목축제2022
2022,강원,2022 상상평화캠프,494842750,0,494842750,9,9,2022 상상평화캠프2022
2022,강원,2022 노벨평화상 수상장 월드서밋 강원,1489525760,0,1489525760,12,12,2022 노벨평화상 수상장 월드서밋 강원2022
2022,강원,전국및도단위체육대회유치,899000000,0,899000000,5,12,전국및도단위체육대회유치2022
2022,강원,철원화강 다슬기축제,1005187700,102393190,902794510,8,8,철원화강 다슬기축제2022
2022,강원,태봉제,739419740,0,739419740,10,10,태봉제2022
2022,강원,한탄강 얼음트레킹행사,1084740450,262000000,822740450,1,1,한탄강 얼음트레킹행사2022
2022,강원,DMZ 피스트레인 뮤직페스티벌,582829000,96552000,486277000,10,10,DMZ 피스트레인 뮤직페스티벌2022
2022,강원,철원 한탄강 물윗길 트레킹,857190051,646139500,211050551,10,4,철원 한탄강 물윗길 트레킹2022
2022,강원,고석정 꽃밭 행사,2115937430,1100000000,1015937430,5,10,고석정 꽃밭 행사2022
2022,강원,화천 토마토 축제,462651820,6595000,456056820,8,8,화천 토마토 축제2022
2022,강원,곰취축제,0,0,0,5,5,곰취축제2022
2022,강원,배꼽축제,0,0,0,9,9,배꼽축제2022
2022,강원,합강문화제,352106280,0,352106280,10,11,합강문화제2022
2022,강원,만해축전,560000000,0,560000000,8,8,만해축전2022
2022,강원,인제에서꽃길만걷자,545518680,0,545518680,9,10,인제에서꽃길만걷자2022
2022,강원,고성명태축제,579316799,25724500,553592299,10,10,고성명태축제2022
2022,강원,제57회 강원도민체육대회,846890000,0,846890000,6,6,제57회 강원도민체육대회2022
2022,강원,2022 대한민국 온천대축제,700000000,0,700000000,10,10,2022 대한민국 온천대축제2022
2022,강원,양양 송이 축제,544969610,0,544969610,9,10,양양 송이 축제2022
2022,강원,양양 연어 축제,640241820,0,640241820,10,11,양양 연어 축제2022
2022,충북,괴산세계유기농산업엑스포,8552773892,0,8552773892,9,10,괴산세계유기농산업엑스포2022
2022,충북,오송화장품뷰티산업엑스포,2656608226,0,2656608226,10,10,오송화장품뷰티산업엑스포2022
2022,충북,충주호수축제,999637390,0,999637390,7,7,충주호수축제2022
2022,충북,우륵문화제,438807830,0,438807830,9,10,우륵문화제2022
2022,충북,제천국제음악영화제,2650000000,0,2650000000,8,8,제천국제음악영화제2022
2022,충북,추계 한국중등(U-15)축구연맹전,313486192,0,313486192,8,8,추계 한국중등(U-15)축구연맹전2022
2022,충북,제천한방바이오박람회,1419192000,0,1419192000,10,10,제천한방바이오박람회2022
2022,충북,청원생명축제,2424980000,0,2424980000,9,10,청원생명축제2022
2022,충북,세종대왕과 초정약수 축제,590448000,15000000,575448000,10,10,세종대왕과 초정약수 축제2022
2022,충북,청주문화재야행,465739110,0,465739110,8,8,청주문화재야행2022
2022,충북,보은대추축제,538787710,0,538787710,10,10,보은대추축제2022
2022,충북,속리산신화여행축제,395867080,0,395867080,1,12,속리산신화여행축제2022
2022,충북,보은 회인 문화재 야행,200000000,0,200000000,10,10,보은 회인 문화재 야행2022
2022,충북,지용제,349981150,30000000,319981150,4,11,지용제2022
2022,충북,전국규모 체육대회 개최지원,537000000,0,537000000,1,12,전국규모 체육대회 개최지원2022
2022,충북,향수옥천 포도복숭아 축제,589660890,0,589660890,7,7,향수옥천 포도복숭아 축제2022
2022,충북,생거진천 문화축제,646853000,0,646853000,10,10,생거진천 문화축제2022
2022,충북,괴산고추축제,1129331000,0,1129331000,9,9,괴산고추축제2022
2022,충북,엑스포 성공개최 기원  kbs 가요무대,325000000,0,325000000,9,9,엑스포 성공개최 기원  kbs 가요무대2022
2022,충북,음성명작페스티벌,694960005,0,694960005,10,10,음성명작페스티벌2022
2022,충북,소백산철쭉제,500000000,0,500000000,6,6,소백산철쭉제2022
2022,충북,온달문화축제,550000000,0,550000000,10,10,온달문화축제2022
2022,충북,증평인삼골축제,400000000,0,400000000,10,7,증평인삼골축제2022
2022,충남,백제문화제,1780000000,0,1780000000,10,10,백제문화제2022
2022,충남,2022보령해양머드박람회,16291128000,0,16291128000,7,8,2022보령해양머드박람회2022
2022,충남,천안흥타령춤축제,2495703972,300000000,2195703972,9,9,천안흥타령춤축제2022
2022,충남,한국청년회의소 제70차 전국회원대회 개최,760000000,0,760000000,10,10,한국청년회의소 제70차 전국회원대회 개최2022
2022,충남,금강자연미술비엔날레,600000000,0,600000000,8,12,금강자연미술비엔날레2022
2022,충남,박동진판소리명창명고대회,300000000,0,300000000,7,7,박동진판소리명창명고대회2022
2022,충남,고마나루전국향토연극제,350000000,0,350000000,7,7,고마나루전국향토연극제2022
2022,충남,백제문화제,2986574000,309000000,2677574000,10,10,백제문화제2022
2022,충남,석장리 구석기 축제,1075376710,45243078,1030133632,5,5,석장리 구석기 축제2022
2022,충남,공주 문화재 야행,383154780,0,383154780,9,9,공주 문화재 야행2022
2022,충남,바로마켓 직거래장터,340862050,0,340862050,4,11,바로마켓 직거래장터2022
2022,충남,세계유산 활용콘텐츠 구축(미디어아트),1987157650,0,1987157650,9,11,세계유산 활용콘텐츠 구축(미디어아트)2022
2022,충남,세계유산 홍보사업,335098000,0,335098000,2,12,세계유산 홍보사업2022
2022,충남,보령머드축제,4542217000,0,4542217000,7,8,보령머드축제2022
2022,충남,아시안컵 보령국제요트대회,959493869,650000000,309493869,7,7,아시안컵 보령국제요트대회2022
2022,충남,서산해미읍성축제,1114648150,0,1114648150,10,10,서산해미읍성축제2022
2022,충남,강경젓갈축제,1003000000,0,1003000000,10,10,강경젓갈축제2022
2022,충남,논산딸기축제,587921530,0,587921530,2,2,논산딸기축제2022
2022,충남,강경문화재 야행 사업,700000000,0,700000000,8,8,강경문화재 야행 사업2022
2022,충남,이통장체육대회,302938500,302938500,0,10,10,이통장체육대회2022
2022,충남,2022계룡세계군문화엑스포,1237533381,150000000,1087533381,10,10,2022계룡세계군문화엑스포2022
2022,충남,기지시줄다리기 민속축제,428500000,61408000,367092000,5,5,기지시줄다리기 민속축제2022
2022,충남,금산인삼축제,2500000000,0,2500000000,9,10,금산인삼축제2022
2022,충남,금산다락원 기획초청공연,548249150,0,548249150,1,12,금산다락원 기획초청공연2022
2022,충남,금산삼계탕축제,533000000,0,533000000,7,7,금산삼계탕축제2022
2022,충남,한산모시문화제,1461548430,45000000,1416548430,6,6,한산모시문화제2022
2022,충남,청양 고추구기자축제,787290230,0,787290230,8,8,청양 고추구기자축제2022
2022,충남,문예회관 문화예술 공연행사,0,0,0,2,12,문예회관 문화예술 공연행사2022
2022,충남,예산장터 삼국축제,317961386,0,317961386,10,10,예산장터 삼국축제2022
2022,충남,2022년 군민체육대회,65952650,0,65952650,10,10,2022년 군민체육대회2022
2022,전북,전주세계소리축제,2247108361,100590,2247007771,9,9,전주세계소리축제2022
2022,전북,전주국제발효식품엑스포,1000000000,0,1000000000,10,10,전주국제발효식품엑스포2022
2022,전북,전라북도 브랜드 공연,800000000,13772000,786228000,6,12,전라북도 브랜드 공연2022
2022,전북,도지사기 등 종목별체육대회,627800000,0,627800000,1,12,도지사기 등 종목별체육대회2022
2022,전북,전주국제영화제,3480000000,180000000,3300000000,4,5,전주국제영화제2022
2022,전북,전주비빔밥축제,430000000,0,430000000,10,10,전주비빔밥축제2022
2022,전북,전주대사습놀이 전국대회,539988290,290000000,249988290,8,9,전주대사습놀이 전국대회2022
2022,전북,전주얼티밋 뮤직페스티벌,300000000,0,300000000,8,8,전주얼티밋 뮤직페스티벌2022
2022,전북,"2022 꽃심, 전주정원산업박람회",596704600,0,596704600,6,6,"2022 꽃심, 전주정원산업박람회2022"
2022,전북,2022 전주재즈페스티벌,362759996,0,362759996,6,6,2022 전주재즈페스티벌2022
2022,전북,군산새만금국제철인3종경기대회,305500000,145500000,160000000,5,5,군산새만금국제철인3종경기대회2022
2022,전북,금석배 전국학생 축구대회,890000000,140000000,750000000,2,7,금석배 전국학생 축구대회2022
2022,전북,군산시간여행축제,817596300,70000000,747596300,10,10,군산시간여행축제2022
2022,전북,군산야행,522000000,302760000,219240000,1,12,군산야행2022
2022,전북,전국해양스포츠제전,2156043514,1110000000,1046043514,8,8,전국해양스포츠제전2022
2022,전북,익산서동축제,931525000,70000000,861525000,10,10,익산서동축제2022
2022,전북,익산천만송이국화축제,1284792030,0,1284792030,10,10,익산천만송이국화축제2022
2022,전북,익산 문화재야행,558664800,0,558664800,8,8,익산 문화재야행2022
2022,전북,춘향제,975658000,0,975658000,5,5,춘향제2022
2022,전북,흥부제,309601000,0,309601000,10,10,흥부제2022
2022,전북,김제지평선축제,2069839350,0,2069839350,9,10,김제지평선축제2022
2022,전북,국제종자박람회,498260330,0,498260330,10,10,국제종자박람회2022
2022,전북,진안홍삼축제,890389780,200000000,690389780,10,10,진안홍삼축제2022
2022,전북,무주반딧불축제,2199319210,0,2199319210,8,9,무주반딧불축제2022
2022,전북,세계태권도문화엑스포,399693440,0,399693440,7,7,세계태권도문화엑스포2022
2022,전북,무주산골영화제,1000000000,0,1000000000,6,6,무주산골영화제2022
2022,전북,장수 한우랑 사과랑 축제,1019847700,70000000,949847700,10,10,장수 한우랑 사과랑 축제2022
2022,전북,임실N치즈축제,930000000,505000000,425000000,10,10,임실N치즈축제2022
2022,전북,임실 산타축제,420000000,255000000,165000000,12,12,임실 산타축제2022
2022,전북,임실치즈테마파크 아쿠아 페스티벌,304026120,205026120,99000000,7,8,임실치즈테마파크 아쿠아 페스티벌2022
2022,전북,의견문화제,320000000,50000000,270000000,5,5,의견문화제2022
2022,전북,순창장류축제,1000000000,0,1000000000,10,10,순창장류축제2022
2022,전북,모양성제,867484492,50000000,817484492,9,10,모양성제2022
2022,전남,남도음식문화큰잔치,800000000,0,800000000,10,7,남도음식문화큰잔치2022
2022,전남,명량대첩축제,1600000000,0,1600000000,9,10,명량대첩축제2022
2022,전남,전남 GT(그랜드투어링),629690000,0,629690000,10,10,전남 GT(그랜드투어링)2022
2022,전남,목포항구축제,797501000,0,797501000,10,10,목포항구축제2022
2022,전남,목포문화재야행,624842840,0,624842840,7,9,목포문화재야행2022
2022,전남,2022 목포 뮤직플레이,749075335,0,749075335,9,10,2022 목포 뮤직플레이2022
2022,전남,목포해상W쇼,983992000,0,983992000,1,12,목포해상W쇼2022
2022,전남,제6회 여수음악제,347156658,0,347156658,6,9,제6회 여수음악제2022
2022,전남,전국생활개선회원 한마음대회,449071460,314350020,134721440,9,9,전국생활개선회원 한마음대회2022
2022,전남,여수밤바다 낭만버스커 거리문화공연,475000000,0,475000000,5,10,여수밤바다 낭만버스커 거리문화공연2022
2022,전남,항꾼에 즐기는 아고라순천 문화예술 행사,688826370,0,688826370,3,12,항꾼에 즐기는 아고라순천 문화예술 행사2022
2022,전남,순천푸드앤아트페스티벌,709999995,0,709999995,10,10,순천푸드앤아트페스티벌2022
2022,전남,KOVO컵 프로배구대회,450000000,0,450000000,8,8,KOVO컵 프로배구대회2022
2022,전남,아시아산악자전거선수권대회,805563871,0,805563871,10,10,아시아산악자전거선수권대회2022
2022,전남,코리아오픈배드민턴선수권대회,900000000,0,900000000,4,4,코리아오픈배드민턴선수권대회2022
2022,전남,제61회 전라남도체육대회,1034841050,0,1034841050,5,5,제61회 전라남도체육대회2022
2022,전남,제30회 전라남도장애인체육대회,770775760,0,770775760,5,5,제30회 전라남도장애인체육대회2022
2022,전남,2022년 순천 문화재 야행,987010940,0,987010940,9,12,2022년 순천 문화재 야행2022
2022,전남,마한문화축제,7073870,390000000,-382926130,10,10,마한문화축제2022
2022,전남,시민의날 행사,370664980,0,370664980,10,10,시민의날 행사2022
2022,전남,제12회 곡성세계장미축제,820000000,0,820000000,5,6,제12회 곡성세계장미축제2022
2022,전남,곡성심청어린이대축제,480000000,0,480000000,10,10,곡성심청어린이대축제2022
2022,전남,고흥 유자 석류축제,639085977,0,639085977,11,11,고흥 유자 석류축제2022
2022,전남,서편제보성소리축제,475000000,0,475000000,9,10,서편제보성소리축제2022
2022,전남,화순 도심 속 국화향연,385578000,0,385578000,10,11,화순 도심 속 국화향연2022
2022,전남,치매안심센터운영지원,752218120,0,752218120,1,12,치매안심센터운영지원2022
2022,전남,정남진장흥물축제,1978811770,0,1978811770,7,8,정남진장흥물축제2022
2022,전남,강진만 춤추는 갈대축제,597823000,0,597823000,10,11,강진만 춤추는 갈대축제2022
2022,전남,해남 국화향연,708811000,0,708811000,11,11,해남 국화향연2022
2022,전남,해남미남축제,719918600,0,719918600,11,11,해남미남축제2022
2022,전남,월출산 국화축제,1098270000,0,1098270000,10,11,월출산 국화축제2022
2022,전남,설날장사씨름대회,400000000,0,400000000,1,1,설날장사씨름대회2022
2022,전남,무안연꽃축제,699954460,20000000,679954460,7,7,무안연꽃축제2022
2022,전남,무안청년축제,696138600,0,696138600,10,10,무안청년축제2022
2022,전남,함평나비대축제,951548780,0,951548780,4,5,함평나비대축제2022
2022,전남,대한민국 국향대전,629892000,0,629892000,10,11,대한민국 국향대전2022
2022,전남,영광 e-모빌리티 엑스포,1527700000,0,1527700000,10,10,영광 e-모빌리티 엑스포2022
2022,전남,제22회 영광불갑산상사화축제,419848500,0,419848500,9,9,제22회 영광불갑산상사화축제2022
2022,전남,장성 황룡강 가을꽃 축제,500000000,0,500000000,10,10,장성 황룡강 가을꽃 축제2022
2022,전남,군 체육회 체육행사 개최 지원,650000000,0,650000000,1,12,군 체육회 체육행사 개최 지원2022
2022,경북,국제불빛축제,370895000,0,370895000,9,9,국제불빛축제2022
2022,경북,포항 K-POP 콘서트,623000000,0,623000000,12,12,포항 K-POP 콘서트2022
2022,경북,대한민국 국제해양레저위크,499903000,0,499903000,6,7,대한민국 국제해양레저위크2022
2022,경북,지역특화 스포츠관광산업 육성 사업,792410000,0,792410000,7,12,지역특화 스포츠관광산업 육성 사업2022
2022,경북,제60회 경북도민체육대회,3139000160,1700000000,1439000160,7,7,제60회 경북도민체육대회2022
2022,경북,경북도민생활체육대축전,799456130,0,799456130,10,10,경북도민생활체육대축전2022
2022,경북,신라문화제,2960000000,0,2960000000,9,10,신라문화제2022
2022,경북,신라소리축제 에밀레전,300000000,0,300000000,9,9,신라소리축제 에밀레전2022
2022,경북,화랑대기 전국초등학교 유소년축구대회,0,0,0,8,8,화랑대기 전국초등학교 유소년축구대회2022
2022,경북,동아일보 경주국제마라톤대회,0,0,0,10,10,동아일보 경주국제마라톤대회2022
2022,경북,경북도민체육대회,0,0,0,4,4,경북도민체육대회2022
2022,경북,형산강 연등문화축제,300000000,0,300000000,5,5,형산강 연등문화축제2022
2022,경북,K-트로트 페스티벌 경주2022,600000000,0,600000000,9,9,K-트로트 페스티벌 경주20222022
2022,경북,동아시아문화도시 추진,1024815550,0,1024815550,3,11,동아시아문화도시 추진2022
2022,경북,김천국제가족연극제,397048750,126476760,270571990,7,8,김천국제가족연극제2022
2022,경북,안동민속축제,337000000,0,337000000,9,10,안동민속축제2022
2022,경북,K-뮤지컬 이육사,300000000,100000000,200000000,10,10,K-뮤지컬 이육사2022
2022,경북,실경뮤지컬 왕의나라 ,767000000,230000000,537000000,8,8,실경뮤지컬 왕의나라 2022
2022,경북,안동국제탈춤페스티벌,1800000000,100000000,1700000000,9,10,안동국제탈춤페스티벌2022
2022,경북,안동시민체육대축전,877326250,0,877326250,6,6,안동시민체육대축전2022
2022,경북,제16회 안동 IAEC 세계총회,910097500,273029250,637068250,10,10,제16회 안동 IAEC 세계총회2022
2022,경북,2022 안동 K-POP 콘서트,370000000,120000000,250000000,10,10,2022 안동 K-POP 콘서트2022
2022,경북,경북 바이오생명 엑스포,938750090,469375050,469375040,10,10,경북 바이오생명 엑스포2022
2022,경북,2022 제18회 세계역사도시회의 행사대행 용역,397420810,119226250,278194560,11,11,2022 제18회 세계역사도시회의 행사대행 용역2022
2022,경북,영주시민 체육대회,382153560,0,382153560,9,9,영주시민 체육대회2022
2022,경북,선비문화축제,592000000,0,592000000,5,5,선비문화축제2022
2022,경북,영천보현산별빛축제,433586730,52000000,381586730,10,10,영천보현산별빛축제2022
2022,경북,영천한약축제,549801459,0,549801459,10,10,영천한약축제2022
2022,경북,제9회 경상북도 평생학습박람회,200000000,200000000,0,10,10,제9회 경상북도 평생학습박람회2022
2022,경북,2022 소울푸드축제,755587970,0,755587970,10,10,2022 소울푸드축제2022
2022,경북,문경사과축제,430000000,0,430000000,10,10,문경사과축제2022
2022,경북,문경찻사발축제,1060162640,0,1060162640,4,5,문경찻사발축제2022
2022,경북,경산자인단오제,550000000,0,550000000,6,6,경산자인단오제2022
2022,경북,청송사과축제,839972590,0,839972590,11,11,청송사과축제2022
2022,경북,영양산나물축제,500000000,52000000,448000000,5,5,영양산나물축제2022
2022,경북,영양고추 H.O.T Festival,383927900,0,383927900,8,8,영양고추 H.O.T Festival2022
2022,경북,영양고추아가씨선발대회,309052100,0,309052100,8,8,영양고추아가씨선발대회2022
2022,경북,영양군민체육대회,376909470,0,376909470,10,10,영양군민체육대회2022
2022,경북,영덕대게축제,473179000,0,473179000,12,1,영덕대게축제2022
2022,경북,전국단위 체육대회 개최,1253541380,0,1253541380,1,12,전국단위 체육대회 개최2022
2022,경북,지역특화스포츠관광산업육성사업,864873570,0,864873570,9,12,지역특화스포츠관광산업육성사업2022
2022,경북,청도반시축제,440334000,0,440334000,10,10,청도반시축제2022
2022,경북,청도세계코미디아트페스티벌,631427380,0,631427380,10,10,청도세계코미디아트페스티벌2022
2022,경북,2020 고령 대가야 문화재 야행,400000000,1941000,398059000,10,10,2020 고령 대가야 문화재 야행2022
2022,경북,2022 대가야체험축제,976000000,29119000,946881000,5,5,2022 대가야체험축제2022
2022,경북,성주생명문화축제 성주참외페스티벌,1197856798,0,1197856798,1,12,성주생명문화축제 성주참외페스티벌2022
2022,경북,성밖숲 와숲행사,400000000,0,400000000,1,12,성밖숲 와숲행사2022
2022,경북,낙동강세계평화 문화 대축전,1779589010,711835600,1067753410,10,10,낙동강세계평화 문화 대축전2022
2022,경북,예천 농산물대축제,386469280,0,386469280,10,10,예천 농산물대축제2022
2022,경북,예천곤충축제,2434218830,0,2434218830,8,8,예천곤충축제2022
2022,경북,봉화은어축제,1660122016,0,1660122016,7,8,봉화은어축제2022
2022,경북,봉화송이축제,504787220,0,504787220,9,10,봉화송이축제2022
2022,경북,코리아컵 국제요트대회,440000000,0,440000000,8,8,코리아컵 국제요트대회2022
2022,경북,군민체육대회,540000000,0,540000000,1,12,군민체육대회2022
2022,경북,죽변항 수산물 축제,337737210,0,337737210,12,12,죽변항 수산물 축제2022
2022,경남,국제조선해양산업전,816439215,0,816439215,12,12,국제조선해양산업전2022
2022,경남,문화다양성 맘프 축제 지원,1000000000,500000000,500000000,10,10,문화다양성 맘프 축제 지원2022
2022,경남,창원평생학습&과학축전,460408879,0,460408879,10,10,창원평생학습&과학축전2022
2022,경남,창원국제용접 및 절단자동화전,314135290,237486279,76649011,10,10,창원국제용접 및 절단자동화전2022
2022,경남,ISSF 월드컵사격대회,846400000,0,846400000,7,7,ISSF 월드컵사격대회2022
2022,경남,마산국화축제,1199870020,42930000,1156940020,10,11,마산국화축제2022
2022,경남,이순신방위산업전,490605720,0,490605720,12,12,이순신방위산업전2022
2022,경남,2022년 창원 e-페스타,956207810,0,956207810,11,11,2022년 창원 e-페스타2022
2022,경남,2022 국제조선해양산업전,816149835,0,816149835,12,12,2022 국제조선해양산업전2022
2022,경남,경상남도 생활체육 대축전 개최,1433072160,266500000,1166572160,10,10,경상남도 생활체육 대축전 개최2022
2022,경남,코리아 드라마 페스티벌,994974870,800000000,194974870,10,11,코리아 드라마 페스티벌2022
2022,경남,진주국화전시회,557260720,0,557260720,10,11,진주국화전시회2022
2022,경남,진주 논개제,748788000,0,748788000,5,5,진주 논개제2022
2022,경남,개천예술제,1219838000,0,1219838000,10,11,개천예술제2022
2022,경남,진주국제농식품박람회,2043633156,500000000,1543633156,11,11,진주국제농식품박람회2022
2022,경남,진주남강유등축제,2780000000,30000000,2750000000,10,10,진주남강유등축제2022
2022,경남,토요 상설 소싸움 대회,342436000,0,342436000,4,9,토요 상설 소싸움 대회2022
2022,경남,진주수상뮤직페스티벌,319990020,0,319990020,8,8,진주수상뮤직페스티벌2022
2022,경남,자발적 시민 커뮤니티 활성화,688597000,0,688597000,5,12,자발적 시민 커뮤니티 활성화2022
2022,경남,지역문화진흥공모사업,486500000,0,486500000,9,12,지역문화진흥공모사업2022
2022,경남,이순신장군배 국제요트대회,392253294,0,392253294,11,11,이순신장군배 국제요트대회2022
2022,경남,통영 ITU 트라이애슬론 월드컵,398000000,0,398000000,10,10,통영 ITU 트라이애슬론 월드컵2022
2022,경남,통영국제음악제,1414897607,0,1414897607,3,4,통영국제음악제2022
2022,경남,윤이상국제음악콩쿠르,576224075,0,576224075,10,11,윤이상국제음악콩쿠르2022
2022,경남,전국춘계대학축구연맹전,400000000,0,400000000,2,2,전국춘계대학축구연맹전2022
2022,경남,통영한산대첩축제,1019521140,0,1019521140,8,8,통영한산대첩축제2022
2022,경남,문화재 야행사업,0,0,0,1,12,문화재 야행사업2022
2022,경남,사천에어쇼,1567509957,0,1567509957,10,10,사천에어쇼2022
2022,경남,사천시민체육대회,350000000,0,350000000,9,9,사천시민체육대회2022
2022,경남,김해분청도자기축제,381290000,0,381290000,10,10,김해분청도자기축제2022
2022,경남,밀양아리랑대축제,2160000000,210000000,1950000000,9,9,밀양아리랑대축제2022
2022,경남,나노융합산업전,346897000,0,346897000,11,11,나노융합산업전2022
2022,경남,해양스포츠 바다로세계로,504000000,0,504000000,7,7,해양스포츠 바다로세계로2022
2022,경남,거제섬꽃축제,347864370,0,347864370,10,11,거제섬꽃축제2022
2022,경남,문화재 야행사업,395000000,0,395000000,9,9,문화재 야행사업2022
2022,경남,양산삽량문화축전,691137400,0,691137400,9,10,양산삽량문화축전2022
2022,경남,경상남도장애인생활체육대회,358103940,298103940,60000000,9,9,경상남도장애인생활체육대회2022
2022,경남,통도사 미디어아트 ,2000000000,0,2000000000,9,10,통도사 미디어아트 2022
2022,경남,민속소싸움 대회,351422000,0,351422000,1,12,민속소싸움 대회2022
2022,경남,의령리치리치페스티벌,485337520,0,485337520,10,10,의령리치리치페스티벌2022
2022,경남,아라가야문화제,500000000,0,500000000,7,7,아라가야문화제2022
2022,경남,전국여자축구선수권대회,356756250,0,356756250,7,8,전국여자축구선수권대회2022
2022,경남,지역특화 스포츠관광,420000000,0,420000000,4,11,지역특화 스포츠관광2022
2022,경남,추석장사씨름대회,380000000,0,380000000,9,9,추석장사씨름대회2022
2022,경남,보물섬 마늘축제,651000000,0,651000000,6,6,보물섬 마늘축제2022
2022,경남,독일마을 맥주축제,304614000,36500000,268114000,9,10,독일마을 맥주축제2022
2022,경남,하동야생차문화축제,618091890,0,618091890,5,5,하동야생차문화축제2022
2022,경남,알프스하동섬진강재첩축제,502387820,0,502387820,8,8,알프스하동섬진강재첩축제2022
2022,경남,산청한방약초축제,2394390740,120000000,2274390740,9,10,산청한방약초축제2022
2022,경남,함양산삼축제,1316996000,0,1316996000,9,9,함양산삼축제2022
2022,경남,천령문화제,500000000,0,500000000,10,10,천령문화제2022
2022,경남,춘계 전국 고등 축구대회,480000000,0,480000000,2,2,춘계 전국 고등 축구대회2022
2022,경남,추계 전국고등축구대회,466000000,0,466000000,7,7,추계 전국고등축구대회2022
2022,제주,제주들불축제,866565170,0,866565170,3,3,제주들불축제2022
2022,제주,제주국제관악제 개최,1399994509,0,1399994509,8,11,제주국제관악제 개최2022
2022,제주,제주특별자치도민체육대회,1500000000,0,1500000000,10,10,제주특별자치도민체육대회2022
2022,제주,세계 리더스 보전 포럼,697587500,0,697587500,10,10,세계 리더스 보전 포럼2022
2022,제주,제주포럼,2371000000,668000000,1703000000,9,9,제주포럼2022
2022,제주,삼다공원 야간 힐링콘서트,591925360,0,591925360,7,9,삼다공원 야간 힐링콘서트2022
2022,제주,제주비엔날레,1767220000,0,1767220000,11,2,제주비엔날레2022
2022,제주,탐라문화제,1515960050,0,1515960050,10,10,탐라문화제2022
2022,제주,제주해양레저박람회,597097013,298548510,298548503,9,9,제주해양레저박람회2022
2022,제주,제주감귤박람회,1356126160,0,1356126160,11,11,제주감귤박람회2022
2022,제주,제주레저힐링축제,636533918,0,636533918,9,10,제주레저힐링축제2022
2023,서울,서울 뮤직페스티벌,1062000000,0,1062000000,9,9,서울 뮤직페스티벌2023
2023,서울,왕궁수문장 교대의식 재현,2084991620,0,2084991620,2,12,왕궁수문장 교대의식 재현2023
2023,서울,남산 봉수의식 등 전통문화 재현행사,624900000,0,624900000,2,12,남산 봉수의식 등 전통문화 재현행사2023
2023,서울,제야의 종 타종행사,2409239000,0,2409239000,12,1,제야의 종 타종행사2023
2023,서울,문화가 흐르는 예술마당,1500000000,0,1500000000,4,12,문화가 흐르는 예술마당2023
2023,서울,서울정원박람회,1392508960,0,1392508960,10,11,서울정원박람회2023
2023,서울,서울거리공연 구석구석라이브 운영,1350000000,0,1350000000,3,12,서울거리공연 구석구석라이브 운영2023
2023,서울,한강페스티벌,760000000,0,760000000,5,12,한강페스티벌2023
2023,서울,정조대왕 능행차 재현 행사,628764120,0,628764120,10,10,정조대왕 능행차 재현 행사2023
2023,서울,한강달빛 야시장,1724702448,0,1724702448,5,10,한강달빛 야시장2023
2023,서울,Try Everything 2023,2015371000,0,2015371000,9,9,Try Everything 20232023
2023,서울,"책읽는 한강공원(상, 하반기)",527900000,0,527900000,6,10,"책읽는 한강공원(상, 하반기)2023"
2023,서울,2023년 서울패션위크(춘계 및 추계) 행사,6425541710,0,6425541710,4,10,2023년 서울패션위크(춘계 및 추계) 행사2023
2023,서울,서울도시건축비엔날레,6137373179,0,6137373179,9,10,서울도시건축비엔날레2023
2023,서울,서울라이트 광화문 빛축제 ,3670000000,0,3670000000,12,1,서울라이트 광화문 빛축제 2023
2023,서울,책 읽는 서울광장(상·하반기) 개최,2912000000,0,2912000000,4,11,책 읽는 서울광장(상·하반기) 개최2023
2023,서울,차 없는 잠수교 뚜벅뚜벅 축제,1337011000,0,1337011000,5,11,차 없는 잠수교 뚜벅뚜벅 축제2023
2023,서울,서울라이트 한강 빛섬축제,1427250000,0,1427250000,10,10,서울라이트 한강 빛섬축제2023
2023,서울,2023년 잠수교『찐』플리마켓 행사,536553000,0,536553000,5,11,2023년 잠수교『찐』플리마켓 행사2023
2023,서울,종로 한복축제,346824860,0,346824860,10,10,종로 한복축제2023
2023,서울,문화재 야행,875000000,0,875000000,10,10,문화재 야행2023
2023,서울,문화재야행,460386400,188482900,271903500,10,10,문화재야행2023
2023,서울,용산구 책축제,351961110,0,351961110,9,9,용산구 책축제2023
2023,서울,성동문화마당,350000000,0,350000000,1,12,성동문화마당2023
2023,서울,경동시장 푸드트럭 축제,400000000,400000000,0,10,12,경동시장 푸드트럭 축제2023
2023,서울,댄싱노원,808397489,0,808397489,10,10,댄싱노원2023
2023,서울,노원달빛산책,621751000,0,621751000,10,11,노원달빛산책2023
2023,서울,불광천 벚꽃축제,302000000,70000000,232000000,4,4,불광천 벚꽃축제2023
2023,서울,마포나루 새우젓축제,606931000,110000000,496931000,10,10,마포나루 새우젓축제2023
2023,서울,허준 축제,463187000,0,463187000,10,10,허준 축제2023
2023,서울,구로문화 축제,580000000,0,580000000,10,10,구로문화 축제2023
2023,서울,영등포 여의도 봄꽃축제,398907000,90000000,308907000,4,4,영등포 여의도 봄꽃축제2023
2023,서울,관악강감찬축제,570000000,110000000,460000000,10,10,관악강감찬축제2023
2023,서울,서초구민체육대회,352800000,0,352800000,4,4,서초구민체육대회2023
2023,서울,서초금요음악회,512368000,0,512368000,1,12,서초금요음악회2023
2023,서울,서리풀페스티벌,1074994000,0,1074994000,9,9,서리풀페스티벌2023
2023,서울,봄밤의 클래식 축제,377474000,0,377474000,4,4,봄밤의 클래식 축제2023
2023,서울,국제평화마라톤,392032420,0,392032420,10,10,국제평화마라톤2023
2023,서울,강남구민체육대회,454004240,0,454004240,5,5,강남구민체육대회2023
2023,서울,강남페스티벌,2558546928,70000000,2488546928,10,10,강남페스티벌2023
2023,서울,365일FUN&FUN강남,341349400,0,341349400,5,10,365일FUN&FUN강남2023
2023,서울,강남 디자인위크,329050000,30000000,299050000,5,5,강남 디자인위크2023
2023,서울,강남 마이스 관광특구 활성화,711350000,0,711350000,9,10,강남 마이스 관광특구 활성화2023
2023,서울,강남뮤직페스티벌 콘서트 개최,462550000,70000000,392550000,5,5,강남뮤직페스티벌 콘서트 개최2023
2023,서울,서울놀이마당 상설전통공연,411613869,0,411613869,1,12,서울놀이마당 상설전통공연2023
2023,서울,한성백제문화제,1256519000,85000000,1171519000,9,9,한성백제문화제2023
2023,서울,송파구민 체육대회,386482400,0,386482400,5,5,송파구민 체육대회2023
2023,서울,호수의 가을과 겨울 그리고 루미나리에,384218010,190000000,194218010,10,2,호수의 가을과 겨울 그리고 루미나리에2023
2023,부산,부산건축제 운영,800000000,0,800000000,9,9,부산건축제 운영2023
2023,부산,부산국제영화제,5978286429,0,5978286429,10,10,부산국제영화제2023
2023,부산,부산국제광고제,1230965666,532228327,698737339,8,8,부산국제광고제2023
2023,부산,부산콘텐츠마켓,1373188390,670251212,702937178,5,6,부산콘텐츠마켓2023
2023,부산,국제게임전시회 (지스타),2969065527,0,2969065527,11,11,국제게임전시회 (지스타)2023
2023,부산,부산불꽃축제,1700000000,0,1700000000,11,11,부산불꽃축제2023
2023,부산,부산바다축제,869800000,0,869800000,8,8,부산바다축제2023
2023,부산,부산국제록페스티벌,730000000,0,730000000,10,10,부산국제록페스티벌2023
2023,부산,조선통신사축제,878422297,0,878422297,1,1,조선통신사축제2023
2023,부산,대한민국 국제해양레저위크,920000000,520000000,400000000,8,12,대한민국 국제해양레저위크2023
2023,부산,부산국제코미디페스티벌,1198469991,0,1198469991,8,9,부산국제코미디페스티벌2023
2023,부산,부산원아시아페스티벌,3227769250,0,3227769250,10,10,부산원아시아페스티벌2023
2023,부산,피란수도 부산 문화재 야행,510096000,204038400,306057600,8,8,피란수도 부산 문화재 야행2023
2023,부산,아시아필름마켓,2511977546,1281956493,1230021053,10,10,아시아필름마켓2023
2023,부산,2023 지구촌새마을운동 고위급 회의 개최 지원,896120000,0,896120000,7,7,2023 지구촌새마을운동 고위급 회의 개최 지원2023
2023,부산,부산인디커넥트페스티벌,599637460,0,599637460,8,8,부산인디커넥트페스티벌2023
2023,부산,2023부산세계장애인대회,1870000000,950000000,920000000,8,8,2023부산세계장애인대회2023
2023,부산,부산크리스마스트리축제,513457000,0,513457000,12,2,부산크리스마스트리축제2023
2023,부산,부산자갈치축제,310000000,0,310000000,10,10,부산자갈치축제2023
2023,부산,시민마당 운영,23100000,0,23100000,1,12,시민마당 운영2023
2023,부산,영도다리축제,413500000,0,413500000,10,10,영도다리축제2023
2023,부산,WT 영도 트라이애슬론 월드컵,700000000,0,700000000,8,8,WT 영도 트라이애슬론 월드컵2023
2023,부산,빛축제 운영,419999860,0,419999860,10,2,빛축제 운영2023
2023,부산,동래읍성역사축제,631264000,0,631264000,10,10,동래읍성역사축제2023
2023,부산,낙동강 구포나루 축제,454265190,0,454265190,10,10,낙동강 구포나루 축제2023
2023,부산,해운대모래축제,672237100,45000000,627237100,5,5,해운대모래축제2023
2023,부산,해운대 빛 축제 개최,879848520,25000000,854848520,12,1,해운대 빛 축제 개최2023
2023,부산,금정문화축제,399763556,0,399763556,5,5,금정문화축제2023
2023,부산,광안리어방축제,1075000000,75000000,1000000000,5,5,광안리어방축제2023
2023,부산,광안리 M 드론라이트쇼,1706376210,0,1706376210,6,5,광안리 M 드론라이트쇼2023
2023,부산,차성문화제,348000000,0,348000000,10,10,차성문화제2023
2023,대구,대구국제섬유박람회,646000000,0,646000000,3,3,대구국제섬유박람회2023
2023,대구,국제그린에너지엑스포,640000000,0,640000000,4,4,국제그린에너지엑스포2023
2023,대구,대구국제마라톤대회,1649775696,0,1649775696,4,4,대구국제마라톤대회2023
2023,대구,대구국제뮤지컬페스티벌,2836873652,973478162,1863395490,5,6,대구국제뮤지컬페스티벌2023
2023,대구,파워풀대구페스티벌,1800000000,0,1800000000,5,5,파워풀대구페스티벌2023
2023,대구,대구국제오페라축제,2008676645,1500000000,508676645,10,11,대구국제오페라축제2023
2023,대구,대구사진비엔날레,1721000000,0,1721000000,9,11,대구사진비엔날레2023
2023,대구,대구치맥페스티벌,12420856644,0,12420856644,8,9,대구치맥페스티벌2023
2023,대구,대구 국제 미래자동차엑스포,1743059119,0,1743059119,10,10,대구 국제 미래자동차엑스포2023
2023,대구,2023 국제청소년스포츠축제(ICG),933048830,0,933048830,7,7,2023 국제청소년스포츠축제(ICG)2023
2023,대구,대구정원박람회,1417862000,0,1417862000,10,10,대구정원박람회2023
2023,대구,약령시한방문화축제,20000000,0,20000000,5,5,약령시한방문화축제2023
2023,대구,대구앞산축제(제28회대덕제),359986190,0,359986190,5,5,대구앞산축제(제28회대덕제)2023
2023,대구,금호강 바람소리길 축제,469442320,0,469442320,9,9,금호강 바람소리길 축제2023
2023,대구,수성못 페스티벌,436612280,10000000,426612280,9,9,수성못 페스티벌2023
2023,대구,수성빛예술제,598603900,0,598603900,12,12,수성빛예술제2023
2023,대구,100대 피아노콘서트,628187459,0,628187459,9,9,100대 피아노콘서트2023
2023,대구,달성대구현대미술제,802014210,0,802014210,9,10,달성대구현대미술제2023
2023,인천,인천상륙작전 기념주간 행사,731942910,0,731942910,9,9,인천상륙작전 기념주간 행사2023
2023,인천,인천개항장문화재야행,1052556482,736789541,315766941,8,10,인천개항장문화재야행2023
2023,인천,화도진축제,399814200,199724200,200090000,5,5,화도진축제2023
2023,인천,화도진스케이트장 조성,594200000,0,594200000,12,2,화도진스케이트장 조성2023
2023,인천,소래포구축제,628646970,29315510,599331460,9,9,소래포구축제2023
2023,인천,부평풍물대축제,703710000,200000000,503710000,9,9,부평풍물대축제2023
2023,인천,각종 체육활동 운영지원(성인지예산),309532800,0,309532800,1,12,각종 체육활동 운영지원(성인지예산)2023
2023,광주,광주세계김치축제,1163876000,0,1163876000,11,11,광주세계김치축제2023
2023,광주,광주ACE Fair,1750151936,879002536,871149400,9,9,광주ACE Fair2023
2023,광주,광주디자인비엔날레,3299751870,0,3299751870,9,11,광주디자인비엔날레2023
2023,광주,광주미디어아트 페스티벌,1258100000,0,1258100000,10,10,광주미디어아트 페스티벌2023
2023,광주,세계인권도시포럼,549834540,0,549834540,10,10,세계인권도시포럼2023
2023,광주,광주비엔날레,5000000000,0,5000000000,4,7,광주비엔날레2023
2023,광주,광주프린지페스티벌,1287002554,0,1287002554,3,12,광주프린지페스티벌2023
2023,광주,광주창업페스티벌,1329927342,0,1329927342,11,11,광주창업페스티벌2023
2023,광주,광주문화재야행 동구달빛걸음,341732450,239212715,102519735,6,6,광주문화재야행 동구달빛걸음2023
2023,광주,광주 버스킹 월드컵(전환사업),1074573170,0,1074573170,10,10,광주 버스킹 월드컵(전환사업)2023
2023,광주,문화관광축제 지원(충장축제)(전환사업),2280666834,995705480,1284961354,10,10,문화관광축제 지원(충장축제)(전환사업)2023
2023,광주,영산강 서창들녘 억새축제,372077800,0,372077800,10,10,영산강 서창들녘 억새축제2023
2023,대전,대전사이언스페스티벌,1500000000,0,1500000000,10,10,대전사이언스페스티벌2023
2023,대전,전국대회 유치 및 개최,549326445,0,549326445,1,12,전국대회 유치 및 개최2023
2023,대전,대전 0시 축제,2953289000,0,2953289000,8,8,대전 0시 축제2023
2023,대전,2023 대전 동구동락 축제,687921000,300000000,387921000,10,10,2023 대전 동구동락 축제2023
2023,대전,대전효문화뿌리축제,1192258000,300000000,892258000,10,10,대전효문화뿌리축제2023
2023,대전,2023 대전 서구힐링 아트페스티벌,1097444660,0,1097444660,10,10,2023 대전 서구힐링 아트페스티벌2023
2023,대전,유성국화전시회,767409480,0,767409480,10,11,유성국화전시회2023
2023,대전,유성구 어린이 물놀이장,457359430,0,457359430,7,8,유성구 어린이 물놀이장2023
2023,대전,2023 유성온천문화축제,582248000,0,582248000,5,5,2023 유성온천문화축제2023
2023,대전,대덕거리맥주페스티벌,456500000,0,456500000,10,12,대덕거리맥주페스티벌2023
2023,대전,대덕물빛축제,845601000,0,845601000,4,5,대덕물빛축제2023
2023,울산,서머페스티벌,553390245,0,553390245,8,8,서머페스티벌2023
2023,울산,한글문화예술제,570000000,0,570000000,10,10,한글문화예술제2023
2023,울산,수요열린예술무대 뒤란,602000000,57668130,544331870,3,12,수요열린예술무대 뒤란2023
2023,울산,울산공업축제,1700000000,0,1700000000,6,6,울산공업축제2023
2023,울산,울산 불꽃축제,700000000,0,700000000,6,6,울산 불꽃축제2023
2023,울산,태화강 국제 재즈페스티벌,320000000,0,320000000,5,5,태화강 국제 재즈페스티벌2023
2023,울산,울산마두희축제,650000000,0,650000000,6,6,울산마두희축제2023
2023,울산,울산고래축제,1430703960,250000000,1180703960,5,5,울산고래축제2023
2023,울산,구립교향악단 정기연주회,610786340,0,610786340,1,12,구립교향악단 정기연주회2023
2023,울산,울산조선해양축제,545000000,0,545000000,8,8,울산조선해양축제2023
2023,울산,울산쇠부리축제,599974594,200000000,399974594,5,5,울산쇠부리축제2023
2023,울산,울산옹기축제,879017260,228080000,650937260,5,5,울산옹기축제2023
2023,울산,간절곶해맞이행사,565495600,200000000,365495600,12,1,간절곶해맞이행사2023
2023,울산,울산울주세계산악영화제,2900000000,1000000000,1900000000,10,10,울산울주세계산악영화제2023
2023,울산,영남알프스 트레일러닝 대회,996000000,747000000,249000000,10,10,영남알프스 트레일러닝 대회2023
2023,세종,세종축제,1169405000,0,1169405000,10,10,세종축제2023
2023,세종,세종시민체육대회,600753000,0,600753000,10,10,세종시민체육대회2023
2023,세종,2023세종가든쇼,500000000,0,500000000,5,5,2023세종가든쇼2023
2023,경기,도(道)단위 생활체육대회 개최,846879420,0,846879420,5,9,도(道)단위 생활체육대회 개최2023
2023,경기,경기국제보트쇼,1339975734,0,1339975734,3,3,경기국제보트쇼2023
2023,경기,플레이엑스포,2082059217,0,2082059217,5,5,플레이엑스포2023
2023,경기,대한민국 우수상품 전시회(G-FAIR KOREA),1500000000,0,1500000000,10,10,대한민국 우수상품 전시회(G-FAIR KOREA)2023
2023,경기,DMZ국제다큐멘터리영화제,3187223000,0,3187223000,9,9,DMZ국제다큐멘터리영화제2023
2023,경기,경기정원문화박람회,574901990,0,574901990,10,10,경기정원문화박람회2023
2023,경기,경기국제웹툰페어,642223817,21366000,620857817,10,10,경기국제웹툰페어2023
2023,경기,DMZ 포럼,1076806476,0,1076806476,7,12,DMZ 포럼2023
2023,경기,경기평화광장 운영,1362411202,0,1362411202,1,12,경기평화광장 운영2023
2023,경기,퓨처 쇼 개최,1100000000,0,1100000000,11,11,퓨처 쇼 개최2023
2023,경기,경기 인디뮤직페스티벌,948992610,260454410,688538200,10,10,경기 인디뮤직페스티벌2023
2023,경기,DMZ 콘서트,2146327249,44364290,2101962959,5,11,DMZ 콘서트2023
2023,경기,DMZ 전시,667565790,0,667565790,8,11,DMZ 전시2023
2023,경기,수원화성문화제,1429100306,48259670,1380840636,10,10,수원화성문화제2023
2023,경기,정조대왕 능행차 연시 ,1220397090,276017444,944379646,10,10,정조대왕 능행차 연시 2023
2023,경기,수원 문화재 야행,410776800,170165670,240611130,8,8,수원 문화재 야행2023
2023,경기,수원연극축제,551208210,57208210,494000000,5,5,수원연극축제2023
2023,경기,수원화성 미디어아트쇼,1713217460,864805730,848411730,10,11,수원화성 미디어아트쇼2023
2023,경기,제8회 아시아태평양 도시포럼,662181000,662181000,0,10,10,제8회 아시아태평양 도시포럼2023
2023,경기,2023 FIVB 여자 발리볼네이션리그,384000000,445215000,-61215000,6,7,2023 FIVB 여자 발리볼네이션리그2023
2023,경기,생물서식처 복원사업,448386818,0,448386818,3,12,생물서식처 복원사업2023
2023,경기,경기도 지역대표공연예술제 지원사업(의정부음악극축제),720023000,100023000,620000000,6,6,경기도 지역대표공연예술제 지원사업(의정부음악극축제)2023
2023,경기,경기관광축제지원사업(블랙뮤직페스티벌),346900000,50000000,296900000,9,9,경기관광축제지원사업(블랙뮤직페스티벌)2023
2023,경기,안양시민축제,848301000,0,848301000,9,9,안양시민축제2023
2023,경기,복사골예술제,360000000,0,360000000,5,5,복사골예술제2023
2023,경기,부천국제판타스틱영화제,3300000000,0,3300000000,6,7,부천국제판타스틱영화제2023
2023,경기,부천국제애니메이션페스티벌,1426950771,0,1426950771,10,10,부천국제애니메이션페스티벌2023
2023,경기,부천국제만화축제,680039619,100000000,580039619,9,9,부천국제만화축제2023
2023,경기,국화전시회 행사,371108860,0,371108860,10,11,국화전시회 행사2023
2023,경기,부천 세계비보이 대회,462260000,83348000,378912000,7,7,부천 세계비보이 대회2023
2023,경기,페스티벌 광명,448816760,0,448816760,10,10,페스티벌 광명2023
2023,경기,2023 제11회 경기정원문화박람회,918573910,0,918573910,10,10,2023 제11회 경기정원문화박람회2023
2023,경기,경기문화창조허브 확대 및 구축 운영,345223820,0,345223820,1,12,경기문화창조허브 확대 및 구축 운영2023
2023,경기,안산국제거리극,1070008000,70008000,1000000000,5,5,안산국제거리극2023
2023,경기,안산 김홍도축제,399250000,0,399250000,10,10,안산 김홍도축제2023
2023,경기,안산 김홍도 장사씨름대회,501300100,0,501300100,10,10,안산 김홍도 장사씨름대회2023
2023,경기,프로당구대회 개최,399933000,0,399933000,7,7,프로당구대회 개최2023
2023,경기,고양국제꽃박람회,2774127000,0,2774127000,4,5,고양국제꽃박람회2023
2023,경기,경기도생활체육대축전 대회 지원,1495384770,0,1495384770,9,9,경기도생활체육대축전 대회 지원2023
2023,경기,2023 대한민국 독서대전,857810000,0,857810000,1,12,2023 대한민국 독서대전2023
2023,경기,경기도생활체육대축전 대회 개최 지원(도비),400000000,400000000,0,9,9,경기도생활체육대축전 대회 개최 지원(도비)2023
2023,경기,과천축제,1338400140,0,1338400140,9,9,과천축제2023
2023,경기,남양주 정약용문화제,379595200,70000000,309595200,10,10,남양주 정약용문화제2023
2023,경기,다산아트홀 공연 운영,364107000,111503940,252603060,5,12,다산아트홀 공연 운영2023
2023,경기,남양주시립박물관 기획전시,317619440,0,317619440,3,12,남양주시립박물관 기획전시2023
2023,경기,생활체육대회 개최 및 출전지원,477600000,0,477600000,10,10,생활체육대회 개최 및 출전지원2023
2023,경기,갯골축제,859799150,0,859799150,1,12,갯골축제2023
2023,경기,마을공동체 축제,380176000,0,380176000,3,12,마을공동체 축제2023
2023,경기,주민자치활성화 사업,627372000,0,627372000,1,12,주민자치활성화 사업2023
2023,경기,전국(도단위) 체육대회,472404670,0,472404670,1,12,전국(도단위) 체육대회2023
2023,경기,처인구민 한마음 체육대회,351901560,0,351901560,9,9,처인구민 한마음 체육대회2023
2023,경기,기흥구민 한마음체육대회,434759940,0,434759940,4,4,기흥구민 한마음체육대회2023
2023,경기,협회별 대회 개최,424678050,0,424678050,1,12,협회별 대회 개최2023
2023,경기,파주개성인삼축제,550000000,0,550000000,10,10,파주개성인삼축제2023
2023,경기,파주장단콩축제,662000000,0,662000000,11,11,파주장단콩축제2023
2023,경기,이천쌀문화축제,1481380047,100000000,1381380047,10,10,이천쌀문화축제2023
2023,경기,설봉산별빛축제,455000000,0,455000000,7,8,설봉산별빛축제2023
2023,경기,읍면동체육행사,345800000,0,345800000,4,11,읍면동체육행사2023
2023,경기,안성맞춤 남사당 바우덕이 축제,1935560900,0,1935560900,10,10,안성맞춤 남사당 바우덕이 축제2023
2023,경기,안성시 시민체육대회,449890110,0,449890110,9,9,안성시 시민체육대회2023
2023,경기,정조효문화제,900000000,0,900000000,10,10,정조효문화제2023
2023,경기,예술단체지원사업,620621000,0,620621000,1,12,예술단체지원사업2023
2023,경기,전국 및 국제 규모 스포츠 대회 개최 및 출전,753030000,0,753030000,1,12,전국 및 국제 규모 스포츠 대회 개최 및 출전2023
2023,경기,정조대왕능행차(화성구간),499999890,0,499999890,10,10,정조대왕능행차(화성구간)2023
2023,경기,제13회 화성 뱃놀이 축제,1878619940,0,1878619940,6,6,제13회 화성 뱃놀이 축제2023
2023,경기,남한산성 문화제,573775000,0,573775000,9,9,남한산성 문화제2023
2023,경기,광주왕실도자기축제,585298010,0,585298010,5,5,광주왕실도자기축제2023
2023,경기,양주 회암사지 왕실축제,468181120,0,468181120,5,5,양주 회암사지 왕실축제2023
2023,경기,양주 천만송이 천일홍 축제,444134000,0,444134000,9,9,양주 천만송이 천일홍 축제2023
2023,경기,양주 회암사지 유네스코 등재 기원 콘서트,550000000,0,550000000,5,5,양주 회암사지 유네스코 등재 기원 콘서트2023
2023,경기,체육회 지원,647961030,0,647961030,1,12,체육회 지원2023
2023,경기,여주도자기축제,982075000,118641000,863434000,5,5,여주도자기축제2023
2023,경기,여주오곡나루축제,1036454000,45000000,991454000,10,10,여주오곡나루축제2023
2023,경기,연천전곡리 구석기축제,1780915780,105948000,1674967780,5,5,연천전곡리 구석기축제2023
2023,경기,자라섬 국제재즈페스티벌,1386840049,0,1386840049,10,10,자라섬 국제재즈페스티벌2023
2023,경기,자라섬 꽃 축제(가을),1141003860,0,1141003860,1,12,자라섬 꽃 축제(가을)2023
2023,경기,양평 용문산 산나물 축제,577264660,0,577264660,4,4,양평 용문산 산나물 축제2023
2023,경기,양평군민의날 체육대회,516097230,0,516097230,9,9,양평군민의날 체육대회2023
2023,강원,평창대관령음악제,975812859,0,975812859,1,12,평창대관령음악제2023
2023,강원,Tour de DMZ 국제자전거 대회,637619060,0,637619060,9,9,Tour de DMZ 국제자전거 대회2023
2023,강원,2023년 강원도농수특산물진품센터 운영,532583191,0,532583191,1,12,2023년 강원도농수특산물진품센터 운영2023
2023,강원,춘천마임축제,637274368,45000000,592274368,5,6,춘천마임축제2023
2023,강원,춘천인형극제,659011254,129759316,529251938,8,12,춘천인형극제2023
2023,강원,춘천향토음식축제,564000842,0,564000842,6,6,춘천향토음식축제2023
2023,강원,장난감축제(토이페스티벌),315000000,30000000,285000000,11,11,장난감축제(토이페스티벌)2023
2023,강원,춘천연극제,419824740,130000000,289824740,7,10,춘천연극제2023
2023,강원,온세대 합창페스티벌,531184958,0,531184958,8,9,온세대 합창페스티벌2023
2023,강원,손흥민 국제 유소년 친선 축구대회,339469170,0,339469170,6,6,손흥민 국제 유소년 친선 축구대회2023
2023,강원,2023 춘천코리아오픈국제태권도대회,1363161968,321458102,1041703866,8,8,2023 춘천코리아오픈국제태권도대회2023
2023,강원,2023 춘천국제레저대회,1100695991,38800000,1061895991,3,12,2023 춘천국제레저대회2023
2023,강원,2023 강원․춘천 세계태권도문화축제,2590210701,26780900,2563429801,8,8,2023 강원․춘천 세계태권도문화축제2023
2023,강원,원주 댄싱카니발,1246267030,0,1246267030,9,9,원주 댄싱카니발2023
2023,강원,원주만두축제,301211040,0,301211040,10,10,원주만두축제2023
2023,강원,원주 MMA 스포츠 페스티벌,599959464,0,599959464,6,12,원주 MMA 스포츠 페스티벌2023
2023,강원,강릉 단오제,1694523210,369652580,1324870630,5,6,강릉 단오제2023
2023,강원,경포썸머페스티벌,360000000,0,360000000,7,8,경포썸머페스티벌2023
2023,강원,강릉관광브랜드공연(관광거점도시),1417707480,921509862,496197618,5,6,강릉관광브랜드공연(관광거점도시)2023
2023,강원,미디어퍼포먼스(관광거점도시),985460000,640549000,344911000,5,6,미디어퍼포먼스(관광거점도시)2023
2023,강원,2023 믹스더블 및 시니어컬링선수권 대회,339557710,223773915,115783795,4,4,2023 믹스더블 및 시니어컬링선수권 대회2023
2023,강원,제58회 강원도민체육대회 및 제16회 강원특별자치도 장애인생활체육대회,1422145040,0,1422145040,6,6,제58회 강원도민체육대회 및 제16회 강원특별자치도 장애인생활체육대회2023
2023,강원,향교서원 문화재 활용사업,438152470,445000000,-6847530,1,12,향교서원 문화재 활용사업2023
2023,강원,문화체육장관기 전국남녀중고태권도대회,370480000,0,370480000,7,8,문화체육장관기 전국남녀중고태권도대회2023
2023,강원,전국추계대학축구연맹전,428289290,0,428289290,8,8,전국추계대학축구연맹전2023
2023,강원,"전국 1,2학년 전국대학축구연맹전",316300852,0,316300852,7,7,"전국 1,2학년 전국대학축구연맹전2023"
2023,강원,설악문화제,775000000,0,775000000,10,10,설악문화제2023
2023,강원,실향민문화축제,650000000,0,650000000,6,6,실향민문화축제2023
2023,강원,삼척맹방유채꽃축제,300000000,0,300000000,4,4,삼척맹방유채꽃축제2023
2023,강원,삼척 황영조 국제마라톤대회,350000000,0,350000000,5,5,삼척 황영조 국제마라톤대회2023
2023,강원,장미축제,400000000,0,400000000,5,5,장미축제2023
2023,강원,삼척동해왕이사부축제,417835470,0,417835470,10,10,삼척동해왕이사부축제2023
2023,강원,홍천강 별빛음악맥주축제,1099958480,9240000,1090718480,8,8,홍천강 별빛음악맥주축제2023
2023,강원,홍천강 꽁꽁축제,1990901760,417116500,1573785260,1,1,홍천강 꽁꽁축제2023
2023,강원,강원 홍천 인삼·한우 명품축제,479039270,2838000,476201270,10,10,강원 홍천 인삼·한우 명품축제2023
2023,강원,읍면 화합의 한마당,393567210,0,393567210,3,11,읍면 화합의 한마당2023
2023,강원,지역문화 활력촉진 사업,868000000,0,868000000,1,12,지역문화 활력촉진 사업2023
2023,강원,평생학습축제,0,0,0,10,10,평생학습축제2023
2023,강원,동강국제사진제,637762000,0,637762000,7,9,동강국제사진제2023
2023,강원,단종문화제,1147544000,145000000,1002544000,4,4,단종문화제2023
2023,강원,김삿갓문화제,554281000,0,554281000,9,9,김삿갓문화제2023
2023,강원,"대한민국 아리랑 대축제, 정선아리랑제",1808640000,0,1808640000,9,9,"대한민국 아리랑 대축제, 정선아리랑제2023"
2023,강원,전국및도단위체육대회유치,1038745000,0,1038745000,1,12,전국및도단위체육대회유치2023
2023,강원,농특산물 마케팅 활성화,471006022,0,471006022,1,12,농특산물 마케팅 활성화2023
2023,강원,철원화강 다슬기축제,1112682000,40643920,1072038080,8,8,철원화강 다슬기축제2023
2023,강원,태봉제,24716000,0,24716000,10,10,태봉제2023
2023,강원,한탄강 얼음트레킹행사,411185590,0,411185590,1,1,한탄강 얼음트레킹행사2023
2023,강원,DMZ 피스트레인 뮤직페스티벌,495539221,0,495539221,9,9,DMZ 피스트레인 뮤직페스티벌2023
2023,강원,철원 한탄강 물윗길 트레킹,326394834,0,326394834,10,4,철원 한탄강 물윗길 트레킹2023
2023,강원,고석정 꽃밭 행사,1481388610,0,1481388610,5,10,고석정 꽃밭 행사2023
2023,강원,화천 토마토 축제,575040090,0,575040090,8,8,화천 토마토 축제2023
2023,강원,얼음나라화천 산천어축제,3261309262,0,3261309262,1,1,얼음나라화천 산천어축제2023
2023,강원,선등문화이벤트운영,1327562510,0,1327562510,12,2,선등문화이벤트운영2023
2023,강원,곰취축제,593000000,0,593000000,5,5,곰취축제2023
2023,강원,배꼽축제,594000000,0,594000000,9,9,배꼽축제2023
2023,강원,제31회 강원도민생활체육대회,961365390,0,961365390,9,9,제31회 강원도민생활체육대회2023
2023,강원,합강문화제,333893180,0,333893180,9,12,합강문화제2023
2023,강원,고성명태축제,560000000,30000000,530000000,10,10,고성명태축제2023
2023,강원,2023 강원도소년체육대회,529908910,0,529908910,4,4,2023 강원도소년체육대회2023
2023,강원,양양 송이 축제,530117680,0,530117680,10,10,양양 송이 축제2023
2023,강원,양양 연어 축제,530117680,0,530117680,10,10,양양 연어 축제2023
2023,강원,양양문화제,555363360,0,555363360,6,6,양양문화제2023
2023,강원,양양 강변 전국마라톤대회 겸 전국 중고교 마라톤대회,300000000,0,300000000,10,10,양양 강변 전국마라톤대회 겸 전국 중고교 마라톤대회2023
2023,충북,솔라페스티벌,540000000,0,540000000,9,9,솔라페스티벌2023
2023,충북,오송화장품뷰티산업엑스포,2673693189,0,2673693189,10,10,오송화장품뷰티산업엑스포2023
2023,충북,우륵문화제,500000000,0,500000000,9,9,우륵문화제2023
2023,충북,통합마케팅활성화,0,0,0,1,12,통합마케팅활성화2023
2023,충북,충주 다이브 페스티벌,1164697770,0,1164697770,6,6,충주 다이브 페스티벌2023
2023,충북,제천국제음악영화제,2490000000,0,2490000000,8,8,제천국제음악영화제2023
2023,충북,추계 한국중등(U-15)축구연맹전,449898243,0,449898243,8,8,추계 한국중등(U-15)축구연맹전2023
2023,충북,제천한방바이오박람회,1490322260,0,1490322260,9,10,제천한방바이오박람회2023
2023,충북,의림지 농경문화예술제,380000000,0,380000000,10,10,의림지 농경문화예술제2023
2023,충북,청원생명축제,2812029850,0,2812029850,10,10,청원생명축제2023
2023,충북,(청주)청주국제공예비엔날레,6272363370,0,6272363370,9,10,(청주)청주국제공예비엔날레2023
2023,충북,세종대왕과 초정약수 축제,930800000,0,930800000,10,10,세종대왕과 초정약수 축제2023
2023,충북,청주문화재야행,489018100,0,489018100,8,8,청주문화재야행2023
2023,충북,보은대추축제,1190000000,0,1190000000,10,10,보은대추축제2023
2023,충북,속리산신화여행축제,407208100,0,407208100,6,6,속리산신화여행축제2023
2023,충북,보은 회인 문화재 야행,395000000,0,395000000,9,9,보은 회인 문화재 야행2023
2023,충북,지용제,450290000,25000000,425290000,5,11,지용제2023
2023,충북,옥천묘목축제,443550000,0,443550000,3,4,옥천묘목축제2023
2023,충북,전국규모 체육대회 개최지원,319385300,0,319385300,1,11,전국규모 체육대회 개최지원2023
2023,충북,영동난계국악축제,1099199780,0,1099199780,10,10,영동난계국악축제2023
2023,충북,영동포도축제,945994000,0,945994000,8,8,영동포도축제2023
2023,충북,대한민국와인축제,454755000,0,454755000,10,10,대한민국와인축제2023
2023,충북,영동 곶감 축제,446633510,0,446633510,1,1,영동 곶감 축제2023
2023,충북,제62회 충북도민체육대회 개최 지원(보조),459646790,0,459646790,5,5,제62회 충북도민체육대회 개최 지원(보조)2023
2023,충북,생거진천 문화축제,616600080,0,616600080,10,10,생거진천 문화축제2023
2023,충북,괴산고추축제,1140000000,0,1140000000,8,9,괴산고추축제2023
2023,충북,괴산김장축제,499235590,0,499235590,11,11,괴산김장축제2023
2023,충북,설성문화제,418426270,0,418426270,9,12,설성문화제2023
2023,충북,음성명작페스티벌,696003120,0,696003120,9,9,음성명작페스티벌2023
2023,충북,문화관광축제 지원사업(품바축제),1014938760,0,1014938760,4,7,문화관광축제 지원사업(품바축제)2023
2023,충북,소백산철쭉제,580000000,0,580000000,5,6,소백산철쭉제2023
2023,충북,온달문화축제,615000000,0,615000000,10,10,온달문화축제2023
2023,충북,증평인삼골축제,491163840,15000000,476163840,10,10,증평인삼골축제2023
2023,충남,백제문화제,1655862650,0,1655862650,9,10,백제문화제2023
2023,충남,내포신도시 순환버스 개통 행사,1631504600,0,1631504600,2,2,내포신도시 순환버스 개통 행사2023
2023,충남,해외투자유치설명회,847702312,0,847702312,10,11,해외투자유치설명회2023
2023,충남,천안흥타령춤축제,2906180089,0,2906180089,10,10,천안흥타령춤축제2023
2023,충남,천안시민체육대회,988810928,0,988810928,10,10,천안시민체육대회2023
2023,충남,K리그 유스 챔피언십 축구대회,370000000,0,370000000,7,8,K리그 유스 챔피언십 축구대회2023
2023,충남,전국노인체육대회,794718160,0,794718160,9,9,전국노인체육대회2023
2023,충남,도시재창조 한마당,806000000,0,806000000,9,9,도시재창조 한마당2023
2023,충남,천안 K-컬처박람회,2963834000,0,2963834000,8,8,천안 K-컬처박람회2023
2023,충남,고마나루전국향토연극제,400000000,200000000,200000000,9,10,고마나루전국향토연극제2023
2023,충남,백제문화제,5662479500,0,5662479500,9,10,백제문화제2023
2023,충남,석장리 구석기 축제,1022123400,0,1022123400,5,5,석장리 구석기 축제2023
2023,충남,공주 문화재 야행,384756800,0,384756800,9,9,공주 문화재 야행2023
2023,충남,세계유산 활용콘텐츠 구축(미디어아트),1732675220,0,1732675220,9,10,세계유산 활용콘텐츠 구축(미디어아트)2023
2023,충남,세계유산 활용사업,484864840,0,484864840,3,12,세계유산 활용사업2023
2023,충남,세계유산 홍보사업,496566740,0,496566740,2,12,세계유산 홍보사업2023
2023,충남,보령머드축제,4578328000,459537000,4118791000,7,8,보령머드축제2023
2023,충남,2023 보령.AMC 모터페스티벌,993412670,0,993412670,5,5,2023 보령.AMC 모터페스티벌2023
2023,충남,아시안컵 보령국제요트대회,999950000,649967500,349982500,7,7,아시안컵 보령국제요트대회2023
2023,충남,시민을 위한 기획공연,582726000,0,582726000,1,12,시민을 위한 기획공연2023
2023,충남,충청남도 장애인체육대회 참가,328283220,0,328283220,9,9,충청남도 장애인체육대회 참가2023
2023,충남,도민체전 참가,565019332,0,565019332,9,9,도민체전 참가2023
2023,충남,생활체육관련 행사지원,834700000,0,834700000,10,10,생활체육관련 행사지원2023
2023,충남,야외 스케이트장 조성,205874910,0,205874910,12,12,야외 스케이트장 조성2023
2023,충남,보령스포츠파크 운영,138502043,0,138502043,1,12,보령스포츠파크 운영2023
2023,충남,성웅이순신축제,1348507060,0,1348507060,4,4,성웅이순신축제2023
2023,충남,아산 문화유산 야행,315000000,0,315000000,6,6,아산 문화유산 야행2023
2023,충남,순국제전,708922800,0,708922800,11,11,순국제전2023
2023,충남,2023 대한민국 온천산업박람회,800000000,0,800000000,10,10,2023 대한민국 온천산업박람회2023
2023,충남,서산해미읍성축제,1643717000,0,1643717000,10,10,서산해미읍성축제2023
2023,충남,읍면동체육대회,615292132,0,615292132,9,12,읍면동체육대회2023
2023,충남,강경젓갈축제,1178086190,0,1178086190,10,10,강경젓갈축제2023
2023,충남,논산딸기축제,1025046100,0,1025046100,3,3,논산딸기축제2023
2023,충남,계룡 軍 문화축제,2642465240,0,2642465240,10,10,계룡 軍 문화축제2023
2023,충남,기지시줄다리기 민속축제,537750000,0,537750000,4,4,기지시줄다리기 민속축제2023
2023,충남,금산인삼축제,3500000000,0,3500000000,10,10,금산인삼축제2023
2023,충남,금산삼계탕축제,1026500000,26500000,1000000000,7,7,금산삼계탕축제2023
2023,충남,백제고도부여국화축제,612282000,0,612282000,10,11,백제고도부여국화축제2023
2023,충남,문화재야행,695985000,0,695985000,9,9,문화재야행2023
2023,충남,2022 부여 세계유산 미디어아트 페스티벌,1736885000,0,1736885000,9,10,2022 부여 세계유산 미디어아트 페스티벌2023
2023,충남,한산모시문화제,831449000,0,831449000,6,6,한산모시문화제2023
2023,충남,장항 맥문동 꽃축제,373023977,0,373023977,8,8,장항 맥문동 꽃축제2023
2023,충남,청양 고추구기자축제,888631230,0,888631230,9,9,청양 고추구기자축제2023
2023,충남,문예회관 문화예술 공연행사,434590000,0,434590000,1,12,문예회관 문화예술 공연행사2023
2023,충남,홍성한우바베큐페스티벌,925038200,0,925038200,11,11,홍성한우바베큐페스티벌2023
2023,충남,예산장터 삼국축제,626498570,0,626498570,10,10,예산장터 삼국축제2023
2023,충남,제33회 예산군민체육대회(삽교읍),309998400,0,309998400,9,9,제33회 예산군민체육대회(삽교읍)2023
2023,전북,전주세계소리축제,2583081905,104119000,2478962905,9,9,전주세계소리축제2023
2023,전북,전주국제발효식품엑스포,1350000000,328200000,1021800000,10,10,전주국제발효식품엑스포2023
2023,전북,전라북도 브랜드 공연,866477325,398294207,468183118,6,11,전라북도 브랜드 공연2023
2023,전북,시각예술 진흥을 위한 기획전시,825022959,0,825022959,1,12,시각예술 진흥을 위한 기획전시2023
2023,전북,아시아 태평양 마스터스대회 개최,5549027000,270000000,5279027000,5,5,아시아 태평양 마스터스대회 개최2023
2023,전북,제60회 도민체육대회,577398910,0,577398910,9,9,제60회 도민체육대회2023
2023,전북,전주국제영화제,3500000000,0,3500000000,4,5,전주국제영화제2023
2023,전북,전주비빔밥축제,800000000,0,800000000,10,10,전주비빔밥축제2023
2023,전북,전주대사습놀이 전국대회,540000000,0,540000000,5,6,전주대사습놀이 전국대회2023
2023,전북,한옥마을배 전국축구대회,65000000,0,65000000,9,9,한옥마을배 전국축구대회2023
2023,전북,전주독서대전,325994160,0,325994160,10,10,전주독서대전2023
2023,전북,전주시민체육대회,343913000,0,343913000,10,10,전주시민체육대회2023
2023,전북,전주얼티밋 뮤직페스티벌,300000000,0,300000000,8,8,전주얼티밋 뮤직페스티벌2023
2023,전북,전주정원산업박람회,746721500,0,746721500,5,5,전주정원산업박람회2023
2023,전북,군산새만금국제마라톤,600000000,100000000,500000000,4,4,군산새만금국제마라톤2023
2023,전북,금석배 전국학생 축구대회,900000000,150000000,750000000,2,7,금석배 전국학생 축구대회2023
2023,전북,군산시간여행축제,880673950,70000000,810673950,10,10,군산시간여행축제2023
2023,전북,군산야행,420000000,243600000,176400000,1,12,군산야행2023
2023,전북,익산서동축제,1032394000,50000000,982394000,9,9,익산서동축제2023
2023,전북,익산천만송이국화축제,1594037970,23800000,1570237970,10,10,익산천만송이국화축제2023
2023,전북,익산 문화재야행,676644000,0,676644000,4,4,익산 문화재야행2023
2023,전북,도시혁신산업박람회,997266000,0,997266000,10,10,도시혁신산업박람회2023
2023,전북,정읍사문화제,390660280,0,390660280,10,10,정읍사문화제2023
2023,전북,구절초 축제,708882170,0,708882170,10,10,구절초 축제2023
2023,전북,춘향제,1879723670,0,1879723670,5,5,춘향제2023
2023,전북,흥부제,308174260,40000000,268174260,10,10,흥부제2023
2023,전북,남원 코리아오픈 국제롤러 경기대회,320000000,0,320000000,4,4,남원 코리아오픈 국제롤러 경기대회2023
2023,전북,남원국제드론제전,3609111210,500000000,3109111210,10,10,남원국제드론제전2023
2023,전북,김제지평선축제,2034103760,0,2034103760,10,10,김제지평선축제2023
2023,전북,국제종자박람회,598771814,0,598771814,10,10,국제종자박람회2023
2023,전북,문화재 야행,320000000,0,320000000,9,9,문화재 야행2023
2023,전북,문화예술회관 기획공연,320000000,0,320000000,4,12,문화예술회관 기획공연2023
2023,전북,진안홍삼축제,999816770,215579584,784237186,9,9,진안홍삼축제2023
2023,전북,무주반딧불축제,2199319210,0,2199319210,9,9,무주반딧불축제2023
2023,전북,세계태권도문화엑스포,500000000,0,500000000,8,8,세계태권도문화엑스포2023
2023,전북,무주산골영화제,1000000000,150000000,850000000,6,6,무주산골영화제2023
2023,전북,장수 한우랑 사과랑 축제,1220000000,70000000,1150000000,9,9,장수 한우랑 사과랑 축제2023
2023,전북,임실N치즈축제,1030000000,0,1030000000,10,10,임실N치즈축제2023
2023,전북,임실 산타축제,300000000,0,300000000,12,12,임실 산타축제2023
2023,전북,임실치즈테마파크 아쿠아 페스티벌,400000000,400000000,0,7,8,임실치즈테마파크 아쿠아 페스티벌2023
2023,전북,의견문화제,300000000,30000000,270000000,1,5,의견문화제2023
2023,전북,순창장류축제,1050000000,0,1050000000,10,10,순창장류축제2023
2023,전북,모양성제,1024455630,864000000,160455630,10,10,모양성제2023
2023,전북,부안마실축제,1090204320,200000000,890204320,5,5,부안마실축제2023
2023,전북,문화재 야행,307197040,0,307197040,10,10,문화재 야행2023
2023,전북,부안붉은노을축제,540351600,250000000,290351600,10,10,부안붉은노을축제2023
2023,전북,변산 비치파티,390813900,0,390813900,8,8,변산 비치파티2023
2023,전남,남도음식문화큰잔치,1600000000,0,1600000000,10,10,남도음식문화큰잔치2023
2023,전남,전남 GT(그랜드투어링),639978000,0,639978000,9,9,전남 GT(그랜드투어링)2023
2023,전남,목포항구축제,968421400,677894980,290526420,10,10,목포항구축제2023
2023,전남,유달산 꽃축제,309240000,210000000,99240000,4,4,유달산 꽃축제2023
2023,전남,목포문화재야행,603186990,313657230,289529760,10,10,목포문화재야행2023
2023,전남,목포문학박람회,1000000000,700000000,300000000,9,9,목포문학박람회2023
2023,전남,목포해상W쇼,823864200,566704940,257159260,1,12,목포해상W쇼2023
2023,전남,목포노을드론라이트쇼,532558390,50000000,482558390,10,10,목포노을드론라이트쇼2023
2023,전남,여수 거북선 축제,1006320436,0,1006320436,5,5,여수 거북선 축제2023
2023,전남,여수밤바다 불꽃축제,445000000,0,445000000,10,10,여수밤바다 불꽃축제2023
2023,전남,여수밤바다 낭만버스커 거리문화공연,500000000,0,500000000,4,10,여수밤바다 낭만버스커 거리문화공연2023
2023,전남,제17차 세계에서 가장 아름다운 만 세계총회,435600000,0,435600000,10,10,제17차 세계에서 가장 아름다운 만 세계총회2023
2023,전남,여수동동북축제,300000000,0,300000000,10,10,여수동동북축제2023
2023,전남,항꾼에 즐기는 아고라순천 문화예술 행사,933925700,99658000,834267700,4,11,항꾼에 즐기는 아고라순천 문화예술 행사2023
2023,전남,순천푸드앤아트페스티벌,687654210,28976000,658678210,10,10,순천푸드앤아트페스티벌2023
2023,전남,세계유산축전,2000000000,1400000000,600000000,8,8,세계유산축전2023
2023,전남,남도영화제,1954112404,1000000000,954112404,10,10,남도영화제2023
2023,전남,광양매화축제,290000000,0,290000000,3,3,광양매화축제2023
2023,전남,담양대나무축제,600000000,0,600000000,5,5,담양대나무축제2023
2023,전남,한여름밤 별빛달빛 축제,600000000,0,600000000,12,12,한여름밤 별빛달빛 축제2023
2023,전남,제13회 곡성세계장미축제,745000000,0,745000000,5,5,제13회 곡성세계장미축제2023
2023,전남,제23회 곡성심청어린이대축제,480000000,0,480000000,10,10,제23회 곡성심청어린이대축제2023
2023,전남,구례산수유꽃축제,0,0,0,3,3,구례산수유꽃축제2023
2023,전남,국제철인3종경기,0,0,0,9,9,국제철인3종경기2023
2023,전남,고흥 유자 석류축제,999396920,0,999396920,11,11,고흥 유자 석류축제2023
2023,전남,녹동항 드론쇼 운영,100,0,100,5,11,녹동항 드론쇼 운영2023
2023,전남,서편제보성소리축제,459998040,0,459998040,4,5,서편제보성소리축제2023
2023,전남,보성다향대축제,929003170,0,929003170,4,5,보성다향대축제2023
2023,전남,제11회 보성세계차엑스포,1776898973,0,1776898973,4,5,제11회 보성세계차엑스포2023
2023,전남,치매안심센터운영지원,732733030,0,732733030,1,12,치매안심센터운영지원2023
2023,전남,화순 고인돌 사계절 축제,2978815870,10000000,2968815870,4,10,화순 고인돌 사계절 축제2023
2023,전남,화순군민의 날,505078880,0,505078880,10,10,화순군민의 날2023
2023,전남,강진청자축제,949740970,0,949740970,2,3,강진청자축제2023
2023,전남,대통령기 전국 종별 럭비 선수권 대회,1010000000,0,1010000000,7,7,대통령기 전국 종별 럭비 선수권 대회2023
2023,전남,강진만 춤추는 갈대축제,499579180,0,499579180,10,10,강진만 춤추는 갈대축제2023
2023,전남,해남 국화향연,811711470,0,811711470,11,12,해남 국화향연2023
2023,전남,해남미남축제,719993400,0,719993400,11,11,해남미남축제2023
2023,전남,왕인문화 축제,989998200,0,989998200,3,4,왕인문화 축제2023
2023,전남,월출산 국화축제,347000000,0,347000000,10,11,월출산 국화축제2023
2023,전남,설날장사씨름대회,400000000,0,400000000,1,1,설날장사씨름대회2023
2023,전남,무안연꽃축제,571212910,20000000,551212910,7,7,무안연꽃축제2023
2023,전남,황토갯벌축제,500000000,13224620,486775380,6,6,황토갯벌축제2023
2023,전남,무안청년축제,677177120,0,677177120,11,11,무안청년축제2023
2023,전남,함평나비대축제,1285900000,0,1285900000,4,5,함평나비대축제2023
2023,전남,대한민국 국향대전,1158900000,0,1158900000,10,11,대한민국 국향대전2023
2023,전남,영광 e-모빌리티 엑스포,1170264410,0,1170264410,10,10,영광 e-모빌리티 엑스포2023
2023,전남,제64회 한국민속예술제,762825800,0,762825800,9,9,제64회 한국민속예술제2023
2023,전남,제23회 영광불갑산상사화축제,499982250,0,499982250,9,9,제23회 영광불갑산상사화축제2023
2023,전남,장성 황룡강 (洪)길동무 꽃길 축제,518014820,18014820,500000000,5,5,장성 황룡강 (洪)길동무 꽃길 축제2023
2023,전남,장성 황룡강 가을꽃 축제,800000000,20000000,780000000,10,10,장성 황룡강 가을꽃 축제2023
2023,전남,진도 신비의 바닷길 축제,899805690,0,899805690,4,4,진도 신비의 바닷길 축제2023
2023,전남,진도문화예술제,0,0,0,10,11,진도문화예술제2023
2023,경북,포항스틸아트페스티벌,926465719,0,926465719,10,10,포항스틸아트페스티벌2023
2023,경북, 호미곶한민족해맞이축전,184022500,0,184022500,12,1, 호미곶한민족해맞이축전2023
2023,경북,칠포재즈페스티벌,851232057,0,851232057,1,12,칠포재즈페스티벌2023
2023,경북,대한민국 국제해양레저위크,495724000,0,495724000,6,7,대한민국 국제해양레저위크2023
2023,경북,지역특화 스포츠관광산업 육성 사업,955203000,0,955203000,7,12,지역특화 스포츠관광산업 육성 사업2023
2023,경북,해병대문화축제,485526380,0,485526380,4,4,해병대문화축제2023
2023,경북,신라문화제,0,0,0,10,10,신라문화제2023
2023,경북,화랑대기 전국초등학교 유소년축구대회,1445353841,0,1445353841,5,11,화랑대기 전국초등학교 유소년축구대회2023
2023,경북,동아일보 경주국제마라톤대회,0,0,0,10,10,동아일보 경주국제마라톤대회2023
2023,경북,경주벚꽃축제,0,0,0,3,4,경주벚꽃축제2023
2023,경북,형산강 연등문화축제,0,0,0,5,5,형산강 연등문화축제2023
2023,경북,김천국제가족연극제,393544060,139053572,254490488,7,8,김천국제가족연극제2023
2023,경북,김천자두포도축제,380664128,0,380664128,6,10,김천자두포도축제2023
2023,경북,안동민속축제,770000000,0,770000000,5,5,안동민속축제2023
2023,경북,K-뮤지컬 이육사,300000000,100000000,200000000,9,9,K-뮤지컬 이육사2023
2023,경북,실경뮤지컬 왕의나라 ,767000000,230000000,537000000,5,5,실경뮤지컬 왕의나라 2023
2023,경북,안동국제탈춤페스티벌,1742050970,100000000,1642050970,10,10,안동국제탈춤페스티벌2023
2023,경북,안동시민체육대축전,842738480,0,842738480,9,9,안동시민체육대축전2023
2023,경북,문화재야행(월영야행),380853470,113858640,266994830,7,8,문화재야행(월영야행)2023
2023,경북,2023 안동 K-POP 콘서트,370000000,120000000,250000000,10,10,2023 안동 K-POP 콘서트2023
2023,경북,대한민국 정수대전,352758046,66415000,286343046,5,12,대한민국 정수대전2023
2023,경북,라면캠핑페스티벌,400000000,0,400000000,11,11,라면캠핑페스티벌2023
2023,경북,구미시 낙동강 야외 눈썰매장,335850320,62864000,272986320,12,2,구미시 낙동강 야외 눈썰매장2023
2023,경북,2023 구미 도드람컵 프로배구대회,600000000,0,600000000,7,8,2023 구미 도드람컵 프로배구대회2023
2023,경북,영주풍기인삼축제,810000000,0,810000000,10,10,영주풍기인삼축제2023
2023,경북,선비문화축제,610000000,0,610000000,5,5,선비문화축제2023
2023,경북,영천보현산별빛축제,0,0,0,5,12,영천보현산별빛축제2023
2023,경북,영천한약축제,0,0,0,5,5,영천한약축제2023
2023,경북,영천과일축제,0,0,0,10,10,영천과일축제2023
2023,경북,중악팔공산은빛문화제,0,0,0,9,9,중악팔공산은빛문화제2023
2023,경북,2023년 경상북도 평생학습박람회,449870000,0,449870000,10,10,2023년 경상북도 평생학습박람회2023
2023,경북,상주세계모자페스티벌,1079733150,0,1079733150,10,10,상주세계모자페스티벌2023
2023,경북,시민체육대회,340000000,0,340000000,10,10,시민체육대회2023
2023,경북,문경사과축제,737010000,0,737010000,10,10,문경사과축제2023
2023,경북,문경오미자축제,331422000,0,331422000,9,9,문경오미자축제2023
2023,경북,문경한우축제,400000000,0,400000000,10,10,문경한우축제2023
2023,경북,문경찻사발축제,1500000000,79456933,1420543067,4,5,문경찻사발축제2023
2023,경북,경산자인단오제,550000000,165000000,385000000,6,6,경산자인단오제2023
2023,경북,의성슈퍼푸드마늘축제,821857000,21996000,799861000,11,11,의성슈퍼푸드마늘축제2023
2023,경북,군민체육대회개최,476000000,0,476000000,10,10,군민체육대회개최2023
2023,경북,산수실경뮤지컬 제작지원(박서생2),600000000,0,600000000,8,8,산수실경뮤지컬 제작지원(박서생2)2023
2023,경북,청송사과축제,759995880,0,759995880,11,11,청송사과축제2023
2023,경북,청송아이스클라이밍월드컵,710354970,0,710354970,1,1,청송아이스클라이밍월드컵2023
2023,경북,영양산나물축제,600000000,95000000,505000000,5,5,영양산나물축제2023
2023,경북,영양고추 H.O.T Festival,396660600,0,396660600,9,9,영양고추 H.O.T Festival2023
2023,경북,영양군민체육대회,438551800,0,438551800,10,10,영양군민체육대회2023
2023,경북,영덕대게축제,670000,0,670000,2,2,영덕대게축제2023
2023,경북,전국 및 도단위 체육대회 개최,1727000000,0,1727000000,1,12,전국 및 도단위 체육대회 개최2023
2023,경북,지역특화스포츠관광산업육성사업,996115159,20000000,976115159,1,12,지역특화스포츠관광산업육성사업2023
2023,경북,2023 영덕송이 한마당(브랜드UP),420000000,0,420000000,9,10,2023 영덕송이 한마당(브랜드UP)2023
2023,경북,청도소싸움축제,599727460,0,599727460,4,4,청도소싸움축제2023
2023,경북,청도반시축제,424231400,0,424231400,10,10,청도반시축제2023
2023,경북,청도세계코미디아트페스티벌,648475300,0,648475300,10,10,청도세계코미디아트페스티벌2023
2023,경북,2023 대가야축제,1145000000,109093000,1035907000,3,4,2023 대가야축제2023
2023,경북,성주생명문화축제 성주참외페스티벌,1300000000,0,1300000000,1,12,성주생명문화축제 성주참외페스티벌2023
2023,경북,낙동강세계평화 문화 대축전,1777729300,711091720,1066637580,10,10,낙동강세계평화 문화 대축전2023
2023,경북,예천세계활축제,799867000,0,799867000,5,5,예천세계활축제2023
2023,경북,예천 농산물대축제,473225000,0,473225000,11,11,예천 농산물대축제2023
2023,경북,봉화송이축제,561969249,24055000,537914249,9,9,봉화송이축제2023
2023,경북,제25회 경상북도 장애인체육대회 개최,300000000,0,300000000,5,5,제25회 경상북도 장애인체육대회 개최2023
2023,경북,춘계 한국 중등축구연맹전,432550540,0,432550540,2,2,춘계 한국 중등축구연맹전2023
2023,경북,추계 한국중등축구 연맹전,470533480,0,470533480,8,8,추계 한국중등축구 연맹전2023
2023,경북,U-12 전국 유소년 야구대회(엘리트),314937100,0,314937100,7,8,U-12 전국 유소년 야구대회(엘리트)2023
2023,경북,제33회 경북도민생활대축전 개최,1200000000,0,1200000000,9,9,제33회 경북도민생활대축전 개최2023
2023,경북,제61회 경북도민체육대회 개최,777240600,0,777240600,4,4,제61회 경북도민체육대회 개최2023
2023,경남,문화다양성 맘프 축제 지원,1000000000,500000000,500000000,10,10,문화다양성 맘프 축제 지원2023
2023,경남,진해군항제,1048002680,0,1048002680,3,4,진해군항제2023
2023,경남,진해군악의장페스티벌,489685650,0,489685650,3,4,진해군악의장페스티벌2023
2023,경남,마산국화축제,1337730110,15000000,1322730110,10,11,마산국화축제2023
2023,경남,한.세계화상비즈니스위크,1701724000,250000000,1451724000,11,11,한.세계화상비즈니스위크2023
2023,경남,창원국제스마트팩토리 및 생산제조기술전,349137810,272327492,76810318,10,10,창원국제스마트팩토리 및 생산제조기술전2023
2023,경남,아시아사격선수권대회,862709000,-105000000,967709000,10,11,아시아사격선수권대회2023
2023,경남,ISSF 세계주니어선수권대회,956923131,0,956923131,7,7,ISSF 세계주니어선수권대회2023
2023,경남,코리아 드라마 페스티벌,1100000000,800000000,300000000,10,10,코리아 드라마 페스티벌2023
2023,경남,진주국화전시회,796034600,0,796034600,10,11,진주국화전시회2023
2023,경남,진주 논개제,548539220,0,548539220,5,5,진주 논개제2023
2023,경남,개천예술제,1497553040,0,1497553040,10,10,개천예술제2023
2023,경남,진주국제농식품박람회,2376856630,0,2376856630,11,11,진주국제농식품박람회2023
2023,경남,진주남강유등축제,2780000000,0,2780000000,10,10,진주남강유등축제2023
2023,경남,가요무대,386318040,0,386318040,10,10,가요무대2023
2023,경남,토요 상설 소싸움 대회,413865940,0,413865940,3,10,토요 상설 소싸움 대회2023
2023,경남,진주수상뮤직페스티벌,500000000,0,500000000,8,8,진주수상뮤직페스티벌2023
2023,경남,진주 전통공예 비엔날레,593544592,0,593544592,11,12,진주 전통공예 비엔날레2023
2023,경남,지역문화진흥공모사업,689517000,0,689517000,3,12,지역문화진흥공모사업2023
2023,경남,2023년 아시아역도선수권대회,1186000000,600000000,586000000,5,5,2023년 아시아역도선수권대회2023
2023,경남,이순신장군배 국제요트대회,488415363,0,488415363,11,11,이순신장군배 국제요트대회2023
2023,경남,통영 ITU 트라이애슬론 월드컵,488000000,0,488000000,10,10,통영 ITU 트라이애슬론 월드컵2023
2023,경남,전국춘계대학축구연맹전,485000000,0,485000000,2,2,전국춘계대학축구연맹전2023
2023,경남,약속의 땅 통영 1.2학년 대학축구대회,390000000,0,390000000,1,1,약속의 땅 통영 1.2학년 대학축구대회2023
2023,경남,전국태권도개인선수권대회,338000000,0,338000000,3,3,전국태권도개인선수권대회2023
2023,경남,와룡문화제,329508800,0,329508800,4,4,와룡문화제2023
2023,경남,사천에어쇼,699963782,0,699963782,11,11,사천에어쇼2023
2023,경남,사천시농업한마당축제,350000000,0,350000000,10,10,사천시농업한마당축제2023
2023,경남,김해분청도자기축제,386209830,20000000,366209830,10,10,김해분청도자기축제2023
2023,경남,가야문화축제,999234720,164400000,834834720,5,5,가야문화축제2023
2023,경남,김해 꽃 축제,300000000,150000000,150000000,5,5,김해 꽃 축제2023
2023,경남,밀양아리랑대축제,2200000000,0,2200000000,5,5,밀양아리랑대축제2023
2023,경남,아리랑가요제,322300000,0,322300000,5,5,아리랑가요제2023
2023,경남,나노융합산업전,348792310,0,348792310,9,9,나노융합산업전2023
2023,경남,거제섬꽃축제,425668610,0,425668610,10,11,거제섬꽃축제2023
2023,경남,거제 옥포대첩 축제,463809940,0,463809940,6,6,거제 옥포대첩 축제2023
2023,경남,문화예술단체 지원,424970000,0,424970000,1,12,문화예술단체 지원2023
2023,경남,문화재 야행사업,419965300,209982650,209982650,10,10,문화재 야행사업2023
2023,경남,경남생활체육대축전,1397912074,0,1397912074,10,10,경남생활체육대축전2023
2023,경남,양산삽량문화축전,967111291,0,967111291,10,10,양산삽량문화축전2023
2023,경남,양산웅상회야제,599937906,0,599937906,5,5,양산웅상회야제2023
2023,경남,민속소싸움 대회,403273040,0,403273040,1,12,민속소싸움 대회2023
2023,경남,의령리치리치페스티벌,826000000,0,826000000,10,10,의령리치리치페스티벌2023
2023,경남,의령홍의장군축제,620987370,0,620987370,4,4,의령홍의장군축제2023
2023,경남,아라가야문화제,550000000,5000000,545000000,10,10,아라가야문화제2023
2023,경남,문화재 야행,222500000,0,222500000,9,9,문화재 야행2023
2023,경남,함안 말이산고분군 미디어아트 페스티벌 ,976000000,0,976000000,10,11,함안 말이산고분군 미디어아트 페스티벌 2023
2023,경남,낙동강 유채축제,468043650,0,468043650,4,4,낙동강 유채축제2023
2023,경남,전국여자축구선수권대회,368000000,0,368000000,7,8,전국여자축구선수권대회2023
2023,경남,추석장사씨름대회,400000000,0,400000000,11,11,추석장사씨름대회2023
2023,경남,보물섬 마늘축제,490000000,0,490000000,6,6,보물섬 마늘축제2023
2023,경남,독일마을 맥주축제,354399380,0,354399380,10,10,독일마을 맥주축제2023
2023,경남,제29회 군민의 날 및 화전문화제,951700000,0,951700000,10,10,제29회 군민의 날 및 화전문화제2023
2023,경남,하동야생차문화축제,309475000,0,309475000,5,6,하동야생차문화축제2023
2023,경남,알프스하동섬진강재첩축제,502387820,0,502387820,8,8,알프스하동섬진강재첩축제2023
2023,경남,산청한방약초축제,2840643500,56216880,2784426620,10,10,산청한방약초축제2023
2023,경남,2023산청세계전통의약항노화엑스포,5919515730,0,5919515730,9,10,2023산청세계전통의약항노화엑스포2023
2023,경남,함양산삼축제,1326674420,0,1326674420,9,9,함양산삼축제2023
2023,경남,천령문화제,500000000,0,500000000,5,5,천령문화제2023
2023,경남,군민체육대회,328169680,0,328169680,10,10,군민체육대회2023
2023,경남,춘계 전국 고등 축구대회,447480000,0,447480000,2,2,춘계 전국 고등 축구대회2023
2023,경남,여왕기 전국여자축구대회,369551000,0,369551000,6,6,여왕기 전국여자축구대회2023
2023,경남,추계 전국고등축구대회,505840000,0,505840000,7,8,추계 전국고등축구대회2023
2023,경남,KB바둑리그,334981430,0,334981430,12,5,KB바둑리그2023
2023,제주,제주들불축제,1368693000,0,1368693000,3,3,제주들불축제2023
2023,제주,서귀포 칠십리축제,613931740,0,613931740,10,10,서귀포 칠십리축제2023
2023,제주,제주국제관악제 개최,1538630820,0,1538630820,3,8,제주국제관악제 개최2023
2023,제주,제주특별자치도민체육대회,1727000000,0,1727000000,4,4,제주특별자치도민체육대회2023
2023,제주,제주포럼,1998000000,668000000,1330000000,5,6,제주포럼2023
2023,제주,탐라문화제,1474767280,0,1474767280,10,10,탐라문화제2023
2023,제주,제주해양레저박람회,599955186,299977593,299977593,9,9,제주해양레저박람회2023
2023,제주,제주감귤박람회,1209691626,11639837,1198051789,11,12,제주감귤박람회2023
2023,제주,서귀포글로컬페스타,1200000000,0,1200000000,10,10,서귀포글로컬페스타2023
2023,제주,제19회 세계농아인대회,977582609,0,977582609,7,7,제19회 세계농아인대회2023
